the	그, 그럴수록, 더욱더
of	~의, ~으로부터, ~을
and	그리고, ~ 및 ~, ~하고, 또
to	~에, ~까지, ~에 대하여, table of organization
in	~안에, ~으로, ~에
I	나, 나는, 내가
that	저것, 것, 그, 다른
was	be의 직설법·과거·1인칭 및 3인칭·단수형
his	그의, 그 사람의, 그의 것, 신의
he	그는, 그것은, 남자, 그 사람은, 신
it	그것, 이것, 그런
with	함께, ~때문에
is	be의 3인칭·단수·직설법·현재형, 모음 앞에서의 iso-의 별형, island
for	~을 위하여, ~을 기념하여, ~용의
as	~처럼, ~으로서, ~하면서
had	have의 과거·과거 분사형
you	당신, 너, 여러분, 자네
not	않다, 아니다, 없다
be	~이다, 있다, 존재하다
her	그녀의, 그녀가, 그녀를, 여자, 그녀에게
on	위에, 계속하여, ~에, ~의 표면에
at	~에, ~으로, ~에서
by	~에 의하여
which	어떤, 어느
have	가지다, 얻다, 걸리다,  낳다, 소유하다
or	말하자면, 또는, 혹은, 즉, ~이나~
from	~에서, ~으로부터, ~부터
this	이것, 지금, 이런, 이렇게, 오늘
him	그를, 남자
but	~만, 하지만, 그러나, 아니면, 뿐만 아니라
all	모든, 모두, 다, 전부, 전혀
she	그녀, 그 여자
they	그들, 그것들, 저들
were	be의 복수 과거형 또는 2인칭 단수 과거형
my	나의, 저의, 난
are	be의 복수형 및 2인칭·단수·직설법·현재, 면적의 단위(아르)
me	나, 나를, 나에게, 나의
one	한번, 하나, 어느, 유일한, 한 개
their	그들의, 그것들의, 그 사람의
so	그래서, 그렇다면, 그렇게, 따라서, 그러니
an	부정관사 a
said	말했다, 이야기했다
them	그것들을, 그들을
we	우리
who	누구
would	~할 것이다, ~하려고 하다, ~할 수 있었다
been	be의 과거 분사형
will	의지, ~할 것이다, 유언
no	없다, 아니다, ~하지 말다, 반대, 부인하다
when	때, 언제, 경우, 얼마쯤에서
there	그곳, 거기, 저기, 저쪽
if	만약, ~라면, 만일
more	더, 더 많은, 더욱, 이상으로, 또한
out	나가다, 밖에, 나오다, 지금까지, 벗어나서
up	위, 오르다, 증가하다, 늘리다, 일어나다
into	들어가다, 속으로, 안으로, 빠져 있다
do	해나가다, 하다, 일, 되어가다, 들어주다
any	어떤, 전혀, 아무, 어느, 누군가
your	당신의, 너의, 여러분의, 자네의
what	무엇, 어떻게, 뭐라고, 무슨, 어떤
has	have의 3인칭·단수·직설법·현재형
man	남자, 사람
could	~할 수 있다, ~하여 주시겠습니까, ~할 수 있을 것이다, ~하여도 좋다, ~할 수 있었을 텐데
other	다른, 기타의, 타인, 나머지의, 반면에
than	보다, 다름아닌, 보다는, ~이외의
our	우리의, 현대의
some	일부, 어떤, 몇, ~중에는, 약간
very	매우, 아주, 정말, 무척, 별로
time	시간, 때, 시기, 동안, 당시
upon	on
about	~에 대하여, 약~, 정도, 좀, 거의
may	것이다, 수도 있다, 지도 모른다, 5월, 아마도
its	그것의, 그, 저것의
only	뿐이다, 유일한, 유일하게, 불과, 단지
now	지금, 이제, 그러면, 자, 곧
like	~같은, 좋아하다, ~하고 싶은, 마치, 마찬가지로
little	좀, 조금, 작은, 약간의, 어린
then	그 이후에, 그렇다면, 그 당시의, 그래서, 게다가
can	할 수 있다, 캔, 통조림
should	~할 것이다, 아마 ~일 것이다, ~하여야 하다
made	만든, 꾸며낸, 인공의, 해내다
did	do의 과거형, 다중 인격 장애(dissociative identity disorder)
us	우리, 미국, 위에 말한 바와 같이
such	~같은, 그러한, 이러한, 그렇게, 매우
a	영어 알파벳의 첫째 자, 하나의, 어떤 하나의, ~이라는 것
great	큰, 좋은, 위대한, 훌륭한, 많은
before	전, 이전에, 앞에
must	~일 것이다, ~임에 틀림없다, ~해야 하다, 반드시 ~하다, 필요한
two	둘
these	이 ~들의, 이런, 이것들
see	보다, 알다, 만나다, 지켜보다, 발견하다
know	알다, 인식하다
over	~이상, 끝나서, 위의, 너무
much	많은, 매우, 훨씬, 크게, 대부분
down	내리다, 지다, 내려가다, 넘어져, 축소하여
after	~후에, ~뒤에, 다음의, 그 후, 나중에
first	첫, 처음의, 최초, 먼저, 우선
Mr	~씨, ~선생
good	좋은, 잘, 훌륭한, 즐거운, 착한
men	남자들, 사람들, 부하들
own	자신의, 스스로 하는, ~자체의, 독자적인, 직접의
never	결코, 절대, 전혀, 설마
most	가장, 대부분의, 거의, 최고, 대다수의
old	나이든, 오래된, 늙은, 노인, 낡은
shall	~해주어야겠다, ~일 것이다, ~할까요, ~해야 하다, ~시키겠다
day	날, 하루, 낮, 데이, 시절
where	어디, 곳, 장소
those	저, 그것, 그들, 저것들
came	왔다
come	오다, 되다, 가다, 나오다, 생기다
himself	자신, 스스로, 자기, 직접, 혼자
way	방법, 방식, 길, 방면, ~점
work	일하다, 작품, 연구, 직장, 작업
life	삶, 인생, 생명, 생활, 평생의
without	~없이, ~하지 않고
go	가다, 계속하다, 떠나다, 출발하다
make	~하게 하다, 만들다, (돈을) 벌다, (소리를) 내다, 이루다
well	잘, 흠, 충분히, 나은, 우물
through	통하여, ~때문에, 지나서, 헤쳐나가다, ~사이를
being	~것, ~됨, ~당함
long	긴, 오래, 오랫동안, 오랜, 장거리의
say	말하다, 전하다, 발언하다, 주장하다, 이야기하다
might	~지도 모른다, ~할 수 있다, ~할지도 모른다
how	어떻게, 얼마나, 방법, 몇, 정말
am	be의 1인칭·단수·직설법·현재형, 오전
too	너무, 또한, 지나치게, 매우
even	평평해지다, 균등해지다, 백중해지다, 같은
def	전적으로, 멋진, 좋은
again	다시, 또, 다시 한 번
many	많은, 여러, 몇, 다수의, 다양한
back	돌아가다, 뒤, 등, 후퇴하다
here	여기, 이곳, 이쪽, 저기
think	생각하다, 같다, 평가하다, 예상하다, 상상하다
every	모든, 마다, 매, 전, 모두
people	사람들, 국민, 주민, 인간, 대중
went	갔다
same	같은, 똑같은, 동일한, 마찬가지로, 일치하는
last	지난, 마지막의, 최종의, 마침내, 끝
thought	생각, 예상, 사고, 의견, 관심
away	떨어져, 떠나, 당장, 멀리, 사라져
under	아래의, ~밑에, ~하에, ~미만의, 지배하에
take	(시간)이 걸리다, 가지다, 받다, 데려가다, 찍다
found	발견했다, 찾아냈다, 알아냈다, 만났다, 설립하다
hand	손, 주다, 도움, 맡기다, 박수
still	아직도, 여전히, 그래도, 가만히, 역시
place	곳, 장소, 놓다, 집, 지역
while	~동안에, ~에 반하여, ~하면서, 잠시, 동시에
just	것만, 그냥, 방금, 단지, 그저
also	또한, 역시, 뿐만 아니라, 마찬가지로, 게다가
young	젊은, 어린, 청년의, 새끼, 경험이 없는
yet	아직, 그러나, 하지만, 여전히, 그런데도
though	비록 ~일지라도, 그러나, ~임에도 불구하고, ~이지만, 그래도
against	~에 대한, 반대로, 대항하여, 반하는, 기대어서
get	받다, 얻다, 걸리다, 가지다, 알아듣다
ever	지금까지, 이전에, 결코, 항상, 언제까지나
give	주다, 전하다, 제공하다, 기부하다, 수여하다
god	신, 세상에, 하느님, 우상
off	없어져, 떨어져, 쉬어, 벗어나, 떠나다
face	얼굴, 직면하다, 표정
nothing	없음, 아무것도 ~아니다, 아무 것, 무
right	권리, 인권, 옳은, 맞는, 바로
once	한 번, 한때, 일단, 일회, 옛날
another	다른, 또 하나, 별개의
left	남았다, 떠났다, 왼쪽, 좌파의
part	부분, 일부, 참가, 지역, 부품
saw	봤다, 톱, 톱질하다
house	집, 주택, 의회, 하우스, 가정의
world	세계, 세상, 월드
head	머리, 지도자
three	셋
took	걸렸다, 받았다, 가졌다, 데려왔다, 뺐었다
new	새로운, 새, 최근의, 신~, 다시
love	사랑하다, 좋아하다, 러브, 애정, 연애
always	항상, 언제나, 늘, 반드시, 줄곧
mrs	~부인, 미세스
put	넣다, 두다, 쓰다, 붙이다, 간단히 말하다
night	밤, 저녁, 야간, 어둠
each	각~, 각자, 한 사람마다
king	왕, 킹, 국왕, 황제, 최고
between	사이에, ~간의, 둘, 양측
tell	말하다, 이야기하다
mind	마음, 반대하다, 생각, 명심하다, 정신
heart	심장, 마음, 가슴, 하트, 중심
few	거의 없는, 몇몇의, 소수의, 소수의 사람, 약간의
because	~때문에, 왜냐하면, ~하다고 해서
thing	것, 일, 상황, 물건, 짓
whom	누구를
far	훨씬, 먼, 많은, 크게, 너무
called	불리는, 라는, 이름의, 명칭의
whole	전체, 전, 모든, 전부, 완전히
de	of, from, un-의 뜻
set	세우다, 정해진, 세트, 놓다, 설정하다
both	둘 모두에게, 두 ~, 양쪽의, 양자, 쌍방의
got	get의 과거·과거 분사형
find	찾다, 발견하다, 알다, 알아보다
done	끝난, 구워진, 마친, 익은, 다 된
heard	들었다
look	보다, 찾다, 표정, 살펴보다, 바라보다
name	이름, 명칭, 성함, 지명하다
days	동안, 날, 며칠, 시절, 시간
told	말했다, 들었다, 이야기했다
let	~하게 해주다, ~하도록 두다, 들여보내다, 방치하다, 세놓다
lord	~왕, 하느님, 경, 주인, 우두머리
country	나라, 국가, 지역, 조국, 분야
asked	요구받은, 부탁받은
going	가기, 계속, 외출, 겪음, 떠나기
seen	보이는, 여겨진, 본 적 있는, 목격된, 아는
better	더 나은, 더 좋은
p	영어 알파벳의 열여섯째 자
having	있어서, 것, 하는, 갖는, 받는
home	집, 가정의, 주택, 고향의, 홈
knew	know의 과거형
side	편, 면, 측, 측면, 옆
something	무언가, 어떤 것, 어떤 일, 중요한 것, 조금
moment	순간, 지금, 잠깐, 때, 기회
father	아버지, 부친, 신부, 창시자, 성직자
among	~중에, ~사이에, 대한, 상호간에, 가운데
course	과정, 코스, 수업, 강좌, 과목
woman	여성, 여자, 여인, 부인
enough	충분한, 충분히, 만큼의, 매우, 족한
mother	어머니, 어미, 수녀원장, 모국의
soon	곧, 빨리, 조만간, ~대로, 바로
full	가득한, 완전한, 전체, 본격적인, 많은
end	종료, 끝나다, 말, 결국, 결과
gave	give의 과거형
room	방, 여지, 공간, 자리, 장소
almost	거의, 대부분, 약, ~에 가까운, 하마터면
small	작은, 소규모의, 적은, 소형의, 약한
thou	1,000개, 그대, 1,000달러
cannot	can not의 복합형
water	물, 바다, 수역, 수분, 수면
want	싶다, 원하다, 바라다, 필요하다, 요구하다
however	그러나, 하지만, 그렇지만, 그런데
light	밝게하다, 조명, 빛, 가벼운, 등
quite	꽤, 상당히, 상당수의, 아주, 제법
brought	가져왔다, 데려왔다, bring의 과거·과거 분사형
nor	~도 또한 ~아니다, ~보다도, ~도 ~도 ~않다
word	말, 단어, 언어, 이야기
whose	누구의, 누구의 것
given	주어진, 받은, 감안하면, 정해진, 얻은
door	문, 현관, 문호, 도어, 출입구
best	최고의, 가장 ~한, 최선의, 베스트, 최대의
turned	되었다, 돌린, 껐다, 바뀌었다, 밝혀졌다
taken	찍은, 받은, 가져간, 실시된, 잡힌
does	do의 3인칭·단수·직설법 현재
use	사용하다, 이용하다, 쓰다
morning	아침, 오전, 새벽, 조간, 안녕하세요
myself	나 자신, 나 스스로, 원래의 나
felt	느껴지는, 느꼈다, 생각했다, 펠트, FEEL의 과거·과거분사
until	~할 때까지, ~까지, ~이 되어 비로소
since	~이후, ~때부터, ~이래, 그 후
power	권력, 힘, 전력의, 권한, 파워
themselves	그들 자신
used	사용된, 이용된, 익숙한, 예전에 자주 ~하다, 중고품의
rather	~보다는, 오히려, 차라리, ~대신, 다소
began	시작했다
present	현재의, 보여주다, 선물하다, 제시하다, 발표하다
voice	목소리, 음성, 소리, 의견, 표현
white	흰, 백인, 화이트, 백색, 선의의
less	덜한, 적게, ~없이, 줄인, 더 작은
money	돈, 자금, 비용, 금액, 상금
next	다음의, 이후의, 차기, 옆에, 앞으로
poor	가난한, 빈곤한, 불쌍한, 빈약한, 부족한
death	죽음, 사망, 사형, 살인, 데스
stood	섰다, stand의 과거·과거 분사형
form	형성하다, 형태, 형식, 만들다, 수단
within	~안에, ~이내에, 내부에, 마음속에, ~의 속에
together	함께, 같이, 서로, 협력하여, 모두
till	때까지, ~ 전
thy	그대의, 당신의, 너의
large	큰, 많은, 대규모의, 거대한, 커다란
matter	문제, 중요하다, 중요한 것, 사안, 사건
kind	종류, 친절한, ~가지, 착한, 부드러운
often	종종, 자주, 많은 경우에, 흔히, 가끔
certain	특정한, 어떤, 확실한, 일정한, 어느 정도의
herself	자신, 스스로, 자기, 혼자, 직접
year	연도, 해, 나이, 학년, 연령
friend	친구, 프랜드, 벗, 동창
half	절반, 전반전, 부분적인, 1/2, 30분
order	주문하다, 명령하다, 질서, 순서, 훈장
round	회, 라운드, 계속, 둥근, 차례
true	사실, 진정한, 실현의, 정말, 진짜의
anything	무엇이든, 아무것도, 어느 것이든, 조금이라도
keep	계속하다, 유지하다, ~인 상태를 지키다, 기르다, 간직하다
sent	보냈다
wife	아내, 부인, 마누라, 와이프, 처
means	수단, 방법, 목적, 부, 수입
believe	믿다, 생각하다, 신뢰하다, 신앙, 신용하다
passed	통과했다, 죽었다, 지나간, 전해졌다, 합격한
feet	발, 피트
near	근처, 가깝게, 인접한, 거의, 접근한
public	대중, 국민, 공공의, 일반인, 공적인
state	국가, 주, 정부, ~을 분명히 말하다, 상태
son	아들, 자식, 자손, 양자
hundred	100, 100달러 지폐
children	아이들, 어린이, 자녀, 아동
thus	따라서, 그렇게, 현재까지, 그렇기 때문에
hope	바라다, 희망하다, ~하면 좋겠다, 기대하다, 소망하다
alone	혼자, 홀로, 다만 ~뿐이다, 고립하여
above	위에, 이상인, 하늘에, 상기(上記)한
case	경우, 사건, 소송, 상황, 상자
dear	친애하는, 이런!, 소중한, 에게, 귀여운
thee	그대를, 너를, thou
says	say의 3인칭·단수·직설법·현재형
person	사람, 인물, 개인, 인간
high	높은, 많은, 첨단의, 큰, 비싼
read	읽다, 독서하다, 독해하다, 쓰여 있다, 낭독하다
city	도시, 시, 시티, 시내, 도심
already	이미, 벌써, 충분히, 이전에, 지금까지
received	받았다, 수상했다, 접수했다, 얻었다, 들었다
fact	사실, 일, 사건, 정보, 진실
gone	지나간, 사라진, 죽은
girl	소녀, 여자아이, 여학생, 미혼여성, 딸
known	알려진, 유명한, 없다, 모르다
hear	듣다, 소식을 듣다, 경청하다
times	번, 배, 타임스, 회, 때
least	가장 적은, 최소의, 마지막으로, 조금도, 적어도
perhaps	아마도, ~일지도 모른다, 어쩌면
sure	확신하고, 확실히, 분명히, 물론, 꼭
indeed	정말로, 사실은
english	영어, 영문학, 영국의, 영국인, 잉글랜드의
open	열다, 개방하다, 오픈, 공개하다, 시작하다
body	몸, 신체, 단체, 시체, 몸매
itself	자체, 스스로, 자신, 自, 자국
along	함께, ~을 따라, 동안에, 가지고, 계속
land	땅, 토지, 착륙하다, 지역, 국토
return	돌아오다, 복귀하다, 돌려주다, 돌아가다, 귀국
leave	떠나다, 남기다, 맡기다, 출발하다
air	공기, 항공의, 공군의, 하늘의, 대기
nature	자연, 본성, 네이처, 천성, 성질
either	또한, 어느 쪽, 역시, 양쪽의, 게다가
law	법, 법안, 법률, 규정, 법칙
help	도움, 돕다, 도와주다, 기여하다
lay	눕다, 낳다, 놓다, 마련하다, 쌓다
point	점, 지적하다, 포인트, 요점, 점수
child	아이, 어린이, 자식, 아동, 유년
letter	편지, 글자, 문서, ~장(狀)
four	넷
wish	바라다, ~좋겠어, 소원, ~싶다, 기원하다
fire	불, 해고하다, 화재, 발사하다, 소방의
women	여성들, 여자들, 여인들, 부인들
speak	말하다, 사용하다, 이야기하다, 연설하다, 알리다
number	수, 다수, 번호, ~을 세다
therefore	따라서, 그러므로, 그래서, 그렇기 때문에, 그러니까
hour	시간, 1시간
held	열었던, 했다, 개최된, 실시된, 가졌다
free	자유의, 무료의, ~이 없는, 해방시키다, 벗어난
war	전쟁, 대전, 군사, 전시
during	~동안, ~중에도, ~사이에
several	몇, 여러 가지의, 몇 가지의, 수 많은, 몇 개의
business	기업, 사업, 산업, 경영, 일
whether	어떨지, ~이든 아니든
er	응급실, 더 ~하는 것
manner	방식, 예의범절, 태도, 매너, 습관
second	두 번째의, 둘째로, 다음으로, 다른
reason	이유, 원인, 이성, 요인, 근거
united	통합한, 통일된, 유나이티드, 연합한, 단결된
call	부르다, 전화하다, 요구하다, 말하다, 연락하다
general	일반의, 장군, 장관의, 전반적인, 보통의
why	왜, 어때요, 이유, 어째서, 그러면
behind	뒤의, 숨겨진, 뒤진, 늦은, 등
became	~되었다
john	요한복음, 요한의 편지, 세례 요한
become	~이 되다, ~해지다, 어울리다
dead	죽은, 사망, 시신, 다 되다, 돌아가신
earth	지구, 땅, 흙
boy	소년, 아이, 남자, 학생, 아들
lost	잃은, 패배한, 난감해진, 분실한, 감량한
forth	앞으로, 밖으로, 이후
thousand	천, 1000
looking	~으로 보이는, 「~하게 보이는」 「생김새가 ~한」의 뜻, ~한 얼굴을 한
family	가족, 식구, 가문
soul	영혼, 정신, 소울, 마음, 아무
feel	느끼다, 기분, 감정
coming	오는, 다가오는, 나오는, 도래
spirit	정신, 사람, 유령, 영혼, 마음
question	질문, 문제, 의문, 묻다, 의심
care	마음쓰다, 보살피다, 돌보다, 관리하다, 상관하다
truth	진실, 사실, 진상, 진리, 진심
ground	땅, 지상의, 기반, 운동장, 그라운드
really	정말, 아주, 사실상, 실제로, 매우
rest	나머지, 쉬다, 휴식, 안심, 죽다
mean	의미하다, 뜻, 수단, 진심으로, 평균
different	다른, 여러 가지의, 종류, 별개의, 독특한
making	만들기, 제작, 제작물, 생산, 제품
possible	가능한, 할 수 있는, 최선
fell	떨어졌다, 감소했다, 빠졌다, 넘어졌다, 내렸다
towards	~을 향하여, ~에 대하여, ~을 위하여, ~쪽으로, 무렵
human	인간, 사람, 인류
kept	계속했다, 유지했다, 지켰다, 상태였다
short	짧은, 단기의, 작은, 간단한, 쇼트
town	마을, 도시, 시, 타운, 동네
following	하기의, 다음의, 따라오는, ~후에, 쫓는
need	필요, 해야 한다, 요구, 수요
cause	일으키다, 원인, 초래하다, 발생하다, 야기하다
met	만난, 기상청, 메트로폴리탄
evening	저녁, 저녁용의, 밤, 말로, 야회
returned	돌려 보내진, 돌아온, 반송된
five	다섯
strong	강한, 강력한, 강력히, 튼튼한, 강세의
able	~할 수 있는, 유능한, 자격 있는, 수완 있는
french	프랑스의, 프랑스어, 프랑스인, 프렌치
live	살다, 생활하다, 생방송의, 거주하다, 생존하다
lady	부인, 여성, 레이디, 숙녀, 아가씨
subject	주제, 과목, 대상, 주어, 받게 하다
answer	답하다, 대답, 해답, 전화를 받다, 응답하다
sea	바다, 바닷가, 해수, 해상, 해양
fear	두려움, 우려, 공포, 걱정하다, 불안
understand	이해하다, 알다, 깨닫다, 납득하다
hard	열심히, 어려운, 힘든, 강경한, 고생
doubt	의심하다, 의혹, 소문, 불확실하다
around	주변에, 주위에, 돌아다니는, 근처에
ask	묻다, 요청하다, 질문하다, 부탁하다, 말씀하다
arms	팔, 무기
turn	되다, 돌리다, 바꾸다, 켜다, 전환하다
sense	감각, 의미, 느끼다, 의식, 감지하다
black	검은, 흑인의, 블랙의, 흑
bring	가지고 다니다, 일으키다, 가져다 주다, 데려오다, 이끌어 내다
beautiful	아름다운, 멋있는, 예쁜, 훌륭한, 화창한
close	가까운, 닫다, 가까이에, 숨겨진, 친한
dark	어두운, 지다, 다크, 검은, 어둠
hold	열다, 보유하다, 잡다, 기다리다
character	캐릭터, 주인공, 인물, 성격, 특징
sort	종류, 분류하다, 추려내다, 방식, 어울리다
sight	보기, 광경, 눈, 시력, 시야
ten	열
show	보여주다, 쇼, 나타나다, 보이고 있다, 전시회
party	정당, 파티, 관계자, 당사자, 단체
fine	좋은, 벌금, 잘, 미세한, 고급의
ye	그대들, 그대들을, the
ready	준비된, 미리, 각오가 된, 사전에
story	이야기, 소설, 스토리, 기사, 줄거리
common	흔한, 공통의, 일반적인, 공동의, 보통의
book	책, 도서, 예약하다, 서적, 저서
electronic	전자기기, 전자의, 전자 장치, 일렉트로닉, 전자 부품
talk	회담, 말하다, 이야기하다, 대화하다, 회의
account	차지하다, 계좌, 회계, 말, 보고
mark	마크, 기념하다, 표시, 기록, 흔적
interest	이자, 관심, 이해관계
written	쓴, 문서의
can't	cannot의 단축형
bed	침대, 재우다, ~층(層), 무덤
necessary	필요한, 필수적인, 불가피한
age	나이, 시대, 오래되다, 노인들, 오랫동안
else	다른, 더, 그 밖에, 아니면
force	군대, 강요하다, 힘, 세력, 효력
idea	생각, 아이디어, 방법, 의견, 개념
longer	더 오래
art	예술, 미술품, 미술, 아트, 기술
spoke	말했다, 이야기했다, 언급했다, 연설했다, 구사했다
across	~ 전역에서, 가로질러서, 건너다, 걸쳐서, 지름으로
brother	형제, 동포, 형씨
early	초, 일찍, 초기, 이른, 어린
ought	~해야 하다, 책임, ~할 필요가 있다, ~임에 틀림없다
sometimes	때때로, 가끔, 종종, 이따금, 어떤 때
line	선, 줄을 서다, 노선, 전화, 라인
saying	~라는 말이 있다, 속담, 발언
table	테이블, 식탁용의, 식탁, 탁자, 식사의
river	강, 하천
continued	계속적인, 연속된, 계속된
eye	눈, 시선, 눈길, 주시, 쳐다보다
sun	태양, 해, 햇볕
information	정보, 자료, 뉴스, 안내, 보도
later	후에, 나중에, 말, 지나, 뒤에
everything	모든, 모든 것, 모두, 만사, 최선
reached	뇌물을 먹은, 부패한
suddenly	갑자기, 순식간에
past	과거의, 지난, 과거형, 최근인, 옛날의
strange	이상한, 낯선, 모르는, 기이한, 처음의
deep	깊은, 심, 매우, 많다, 딥
change	변화, 바꾸다, 변경, 달라지다, 환전하다
miles	남자 이름
feeling	느낌, 기분, 감정, 마음, 예감
act	행동하다, 연기하다, 행위, 법률, 대행하다
meet	만나다
paid	지불된, 유급의, 유료인
further	더, 더 나아가, 더 멀리, 게다가, 그 이상의
purpose	목적, 목표, 용도, 의도, 명분
happy	행복한, 기쁜, 즐거운, 만족한, 축하하다
added	덧붙여, 추가된, 더했다, 부가된, 전했다
seem	~것 같다, ~것처럼 보이다, 생각되다, 느껴지다, 듯하다
taking	듣는, 응시, 고려, 섭취, 취하기
blood	피, 혈액, 혈통, 혈연, 유혈
rose	올랐다, 로즈, 장미
south	남, 남쪽, 남부, 남극, 남향의
beyond	~을 넘어서, ~이상으로, 뛰어넘는, ~이후, ~이외는
cold	추운, 차가워진, 감기, 싸늘해진, 추위
neither	어느  ~도 ~아니다, ~도 또한 ~아니다, ~도 아니고~도 아니다
forward	앞으로, 발전한, 포워드, 전진하는, 진보적인
view	견해, 보기, 관점, 전망, 간주하다
position	입장, 자리, 위치, 지위, 자세
sound	소리, 들리다, 음, 소리를 내다, 건전한
none	아무도 ~않다, 조금도 ~없다, 어떤 ~도 없다
clear	분명해지다, 분명한, 밝아지다, 명확하다, 확실히
road	도로, 길, 길거리
late	말기의, 늦도록, 늦은, 늦게, 최근의
stand	세우다, 서다, 서 있다, 참다, 입장
suppose	생각하다, 예정이다, ~해야만 하다, 가정하다, 추정하다
la	라, 어머나, Los Angeles, lanthanum
daughter	딸, 여성, 양녀, 파생
real	진짜의, 실제의, 진정한, 정말로, 실질의
nearly	거의, 가까이
mine	내 것, 광산, 지뢰, 채굴하다
laws	법, 법안, 법률, 규정, 법칙
knowledge	지식, 아는 것, 학식, 인지
comes	오다, 관해, 위한, 있어서, 끝나다
toward	~에 대한, 향해서, ~쪽으로, 무렵
bad	나쁜, 좋지 않은, 잘못된, 심한, 상한
cut	삭감하다, 자르다, 줄이다, 인하하다, 중단하다
copy	복사하다, 사본, 부, 장, 베끼다
husband	남편
six	여섯
living	살아 있는, 생활의, 생계, 생존하는, 존재하는
peace	평화, 화해, 편히, 조용히, 강화 조약
didn't	did not의 단축형
low	낮은, 최저의, 떨어지는, 적은, 저
north	북, 북쪽, 북부, 북측
remember	기억하다, 생각하다, 잊지 않는다, 상기하다
effect	영향, 효과, 발효, 결과, 시행
natural	자연의, 당연한, 천연의, 타고난, 정상적인
pretty	꽤, 예쁜, 상당한, 멋진, 아름다운
fall	떨어지다, 가을, 감소하다, 하락하다, 폭포
fair	공정한, 공평한, 박람회, 전시회, 타당한
service	서비스, 봉사, 근무
below	아래에, ~이하의, 영하의
except	제외하다, ~외에는, 다만, 반대하다, 이의를 제기하다
hair	머리카락, 털, 섬유
laid	lay의 과거·과거 분사형, 가로 눕힌, 가로놓인
pass	통과하다, 지나가다, 사망하다, 합격하다, 패스
led	이끈, ~하게 하다, 주도한, 이어간, 유발한
copyright	저작권, 판권, 저작권으로 보호하다
doing	하기, 그것, 행동, 활동, 수행
army	군, 군대, 육군
run	달리다, 운영하다, 출마, 열리다, 계속하다
horse	말, 경마, 경주마
future	미래, 앞의, 장래, 선물(先物)
pleasure	즐거움, 기쁘다, 기쁨, 반갑다, 쾌락
history	역사, 이력, 사학, 연혁
west	서부, 서양, 웨스트, 서방, 서
pay	지불하다, 임금, 갚다, 지급하다, 보상하다
red	빨간, 빨개진, 붉은, 빨강, 레드
hath	have의 3인칭·단수·직설법·현재형
note	지적하다, 메모, 적어두다, 지폐, 주목하다
although	비록~이지만, ~임에도 불구하고, ~이지만
wanted	싶었다, 원했다, 바랐다, 수배, 희망했다
gold	금, 금메달, 금색, 황금, 금괴
desire	싶다, 원하다, 욕망, 바라다, 욕구
play	연주하다, 역할을 하다, 게임하다, 경기, (배역을) 맡다
master	마스터, 대가, 주인, 숙달하다, 교사
office	사무소, 회사, 의원, 직무, 공직
tried	노력한, ~하려고 한, 먹어 본, 입어 본
front	앞, 전선, 면, 앞면, 프런트
big	큰, 중요한, 많이, 대단한
lived	~의 생명을 지닌
certainly	분명히, 확실히, 물론이지, 정말로, 반드시
wind	바람, 강풍, 불다, 풍력
receive	받다, 수상하다, 얻다, 당하다, 접수하다
attention	관심, 주의력, 주목, 주의, 집중
government	정부, 부, 국가, 관공서, 행정
unto	to, ~까지, ~에
church	교회, 성당, 기독교
strength	힘, 강점, 강세, 강함, 능력
length	길이, 기간, 거리, 세로
company	회사, 대, 따르다, 출자자, 친구
paper	종이, 논문, 신문, 서류, 용지
letters	문학, 문서
probably	아마도, 아마, 십중팔구는
glad	기쁜, 좋은, 다행인, 고마운, 반가운
important	중요한, 주요한, 중대한, 소중한
especially	특히, 더욱, 두드러지게, 유달리
greater	더, 크다, 많다, 훨씬, 높다
yourself	당신 자신
fellow	동료, 연구원, 사람, 녀석, 회원
bear	곰, 부담하다, 참다, 맺다
opinion	의견, 생각, 여론, 견해, 관점
window	창문, 창, 윈도우, 창구
ran	달렸다, 도망갔다, 달아났다, 경주했다
faith	믿음, 신앙, 신념
ago	전, 지난, 전년, 이전, 오래전에
agreement	합의, 협정, 계약, 동의, 조화
charge	혐의, 기소, 요금, 청구하다, 충전
beauty	아름다움, 미인, 미, 미용의, 미녀
lips	립스
arm	팔, 무기, 무장하다, 부문, 소매
latter	후자의, 하반기의, 후반의
duty	의무, 임무, 관세, 직무, 세금
send	보내다, 전하다, 파견하다, 알리다, 발송하다
distance	거리, 먼 곳, 간격, 먼 데
silence	침묵, 조용하게 만들다, 고요, 묵념
foot	발, 피트, 걷다, 기슭, 보병
wild	야생의, 거친, 열광적인, 엉뚱한, 자유분방한
object	물건, 반대하다, 목적, 대상
die	죽다, 사망하다, 사라지다, 떠나다, 돌아가다
save	구하다, 절약하다, 살리다, 저축하다
gentleman	신사, 여러분, 친절한 사람
green	녹색의, 환경 친화적인, 푸른, 잔디, 야채의
trouble	문제, 곤란, 어려움, 말썽, 고민
smile	미소, 웃다, 미소 짓다, 웃음, 스마일
books	회계장부
wrong	잘못된, 틀린, 문제, 나쁜, 오해하다
various	다양한, 여러가지의, 많은, 얼룩덜룩한
sleep	자다, 재우다, 잠, 수면, 숙면하다
particular	특정한, 특별한, 특수한, 까다로운, 특이한
drew	draw의 과거형
minutes	소송기록
hardly	거의 ~할 것 같지 않다, 거의 ~아니다, 가혹하게, ~하기 어렵다
chief	장관, 국장, 최고의, 주요한, 추장
chance	기회, 가능성, 우연, 가망, 위험
according	따르는, 의한, 따라서, 일치한
beginning	시작, 초, 처음, 기원, 개시
action	행동, 전투, 액션, 효과, 소송
deal	거래, 다루다, 계약, 대처하다, 처리
visit	방문하다, 가다, 찾다, 오다, 체류하다
thinking	생각, 사고, 고려, 할까 하다, 신중한
follow	따르다, 뒤를 잇다, 따라가다, 지켜보다, 지키다
standing	서 있는, 상임의, 입석, 지위, 기립
try	노력하다, 해보다, 시도하다, 애쓰다, 하려고 하다
presence	존재, 주둔, 영향력, 참석
heavy	무거운, 강력한, 중(重)~, 과중한, 심한
sweet	달콤한, 맛좋은, 사랑스러운, 기분좋은, 사탕
plain	평원, 분명한, 평범한, 단순한, 담백한
donations	기부금, 모금, 기증, 자선, 지원
immediately	즉시, 직후, 바로, 곧, 당장
wrote	쓴, 적어 놓은, 작곡한, 집필한
mouth	입, 말, 입구
rich	부자의, 부유한, 풍부한, 많은, 풍요로운
u	영어 알파벳의 스물한째 자
won't	will not의 단축형
afraid	두려운, ~인 것 같다, 미안하지만, 걱정인, 무서워하여
single	하나의, 싱글, 단일의, 독신의, 단식의
joy	기쁨, 즐거움, 행복, 환희, 만족
enemy	적, 적군, 원수, 적대자, 적국
broken	고장난, 부러진, 깨진, 부서진, 어긴
unless	~하지 않는다면, 제외하면, ~한다면 모를까
ship	배, 선박, 선원, 보내다, 선적하다
condition	조건, 상황, 상태, 환경, 병
carry	휴대하다, 수행하다, 싣다, 옮기다, 갖다
including	포함해, 등, 비롯해, 같은, 및
filled	「~으로 가득한」의 뜻
seeing	보는, 만나는, 사귀는
influence	영향, 외압
write	쓰다, 적다, 작성하다, 작곡하다, 작문
appear	~처럼 보이다, 나타나다, 출연하다, ~인 듯하다, 생기다
outside	밖의, 바깥면의, 외부의, 외에, 야외에
secret	비밀, 숨겨진, 비결, 몰래
please	제발, 부디
appearance	외모, 출연, 겉모습, 출전, 출석
evil	사악한, 악, 악마, 나쁜, 해악
march	3월, 행진하다, 시위하다, 진행하다
george	조지, 게오르게, 조르주
whatever	무엇이든, 어떻든 간에
slowly	천천히, 느리게, 점점, 완만하게
caught	잡혔다, 잡았다, 걸렸다, 붙잡혔다
stay	머무르다, 유지하다, 지내다, 보내다, 체류하다
instead	대신에, 보다, 하지만, 그렇기는커녕, 아닌
struck	때린, 발생한, 강타한, 사로잡히다, 체결하다
blue	파란, 푸른, 하늘색의, 우울한, 블루스
impossible	불가능한, ~할 수 없는, 있을 수 없는, 무리한
period	기간, 시대, 시기, 단계, 생리
sister	여동생, 자매, 언니, 누나, 수녀
battle	전투, 싸움, 전쟁, 투쟁, 대결
school	학교, 대학, 학부, 학파
raised	올라갔다, 제기했다, 자랐다, 인상했다, 모았다
occasion	행사, 때, 경우, 기회, 계기
married	결혼한, 부부, 기혼의, 유부남
former	전의, 전임의, 과거의, 전자의
food	음식, 식품, 식량, 먹이, 푸드
youth	젊은이, 어린이, 젊음, 젊은 시절
learned	배웠다, 알았다, 공부, 얻었다, 들었다
merely	단지, 단순히, 그저
reach	도달하다, 이르다, 도착하다, 닿다, 이루다
system	시스템, 제도, 체계, 체제, 장치
twenty	스물, 20달러 지폐
dinner	저녁식사, 저녁, 만찬, 정찬
quiet	조용히, 고요한, 침묵한, 평화로운, 잠잠한
easily	쉽게, 잘, 용이하게, 수월하게, 툭하면
afterwards	나중에, 그 후
giving	마음이 넓은, 호기 있는
walk	걷다, 산책하다, 보행
language	언어, ~어, 말, 어학, 용어
expression	표현, 표현법, 표정, 말, 표시
week	주, 일주일, 주간
hall	넓은 방, 홀, 복도
danger	위험, 위기, 경고, 우려
property	부동산, 재산, 소유, 토지, 땅
wonder	궁금하다, 이상한, 놀라다, 의심하다, 경이로운
usual	평소의, 보통의, 늘, 일반적인
figure	수치, 인물, 피겨, 생각하다, 그림
born	태어난, ~태생의, 타고난
court	법원, 법정, 재판소, 코트, 판사
generally	일반적으로, 대체로, 대개, 보통, 전반적으로
grew	자랐다, 성장했다, 증가했다, 되었다, 키웠다
ancient	고대의, 오래된, 옛날의
respect	존경하다, 존중, 관련되다, 측면, 관계하다
third	3번째, 3분의 1
worth	가치있는, ~어치, ~할 만한, 재산, 중요성
simple	간단한, 단순한, 소박한, 간소한, 간편한
tree	나무, 트리, 가계도, 수목, 관계
leaving	떠나는, 두는, 나가는, 나머지, 쓰레기
remain	남다, 머무르다, 살아남다, 체류하다, 잔존하다
society	사회, 협회, 연구회, 집단, 계층
fight	싸우다, 싸움, 맞서다, 전투, 이기다
wall	벽, 장벽, 성벽, 벽면, 담
result	결국, 결과, 성과, 초래한다, 결정
heaven	천국, 하늘
command	사령부, 지휘하다, 명령하다, 차지하고 있다, 지시하다
tone	어조, 소리, 톤, 신호, 음조
regard	관련되다, 간주하다, 보다, 여기다, 생각하다
expected	예상된, 보인다, 기대된, 전망, 예정
mere	단순한, 단지
month	달, 개월, 월
beside	곁에, 벗어난, ~에 비하면
silent	침묵의, 조용한, 고요한, 무성의, 잠자코
perfect	완벽한, 완전한, 최적의, 퍼펙트, 이상적인
experience	경험, 겪다, 체험, 느끼다
street	거리, 길, 도로, ~가
writing	쓰기, 작문, 작성, 편지하다, 작품
goes	go의 3인칭·단수·현재형, go의 복수형, 정지 실용 환경 위성
entirely	전적으로, 완전히, 전혀, 거의
fresh	신선한, 새로운, 산뜻한
duke	듀크, 공작, 때려 눕히다, 주먹, 무릎
covered	덮개가 있는, 엄호물이 있는, 덮인
bound	묶인, 구속된, 제본한
east	동쪽, 동, 동부
wood	나무, 목제의, 숲, 우드, 목재
stone	돌, 석기의, 보석, 석판, 결석
quickly	빨리, 빠른, 신속히, 급속히, 금방
notice	알아차리다, 공지, 주목하다, 경고, 게시
bright	밝은, 긍정적인, 영리한, 빛나는, 환한
boat	배, 보트
noble	고귀한, 귀족의, 기품, 값비싼
meant	mean의 과거·과거 분사형
somewhat	다소, 약간, 어느 정도, 좀, 얼마간
sudden	갑작스러운, 급작스러운, 돌연한, 성급한, 느닷없이
value	가치관, 가치, 중시하다, 가격, 평가
c.	케이프, 카톨릭교도, 섭씨의, 켈트족, 교회
direction	방향, 지시, 길, 목표
chair	의자, 의장, 자리, 주재하다, 직위
due	예정인, 정당한, 때문에, 세금, 인해
support	지지하다, 지원하다, 뒷받침하다, 돕다, 유지하다
tom	수고양이, 남자 이름, 백인에게 굽실거리다
date	데이트, 날짜, ~일, 시작되다, 만나다
waiting	기다리는 시간, 섬기는, 대기
village	마을, 시골의
lives	인생, 살다, 생명
reading	읽기, 독서, 레딩, 읽을 거리
agree	동의하다, 합의하다, 일치하다, 승낙하다, 제안에 응하다
considered	여겨진다, 간주된다, 생각되다, 고려되다, 평가된다
field	분야, 경기장, 들판, 현장, 필드
scarcely	거의, 겨우, 가까스로
wait	기다리다, 지켜 보다, 대기하다, 기대하다
permission	허가, 허락, 허용, 승인, 동의
success	성공, 성과, 성공한 사람, 달성, 대히트
piece	조각, 작품, 부분, 하나, 일부
british	영국의, 영연방의
ex	~없이, 전남편, X자
formed	생물적 특징을 갖춘, 형성된
speaking	말하는, 연설하는, 이야기하는
trying	괴로운, 시험하는, 고된
conversation	대화, 회화, 교제
proper	적절한, 제대로, 올바른, 타당한
hill	언덕, 산, 비탈, 흙더미
music	음악, 노래
opportunity	기회, 찬스
that's	that is의 단축형
afternoon	오후, 점심
cry	울다, 외치다, 소리치다, 울부짖다, 요구
cost	비용, 얼마이다, 들다, 가격, 경비
allowed	해주다, 허용된, 수 있다, 되다, 허락받은
considerable	상당한, 꽤
c	영어 알파벳의 셋째 자
broke	깼다, 파산한, 무일푼의, 부서졌다, 빈털터리의
honour	영광, 명예
seven	일곱
private	민간의, 개인의, 사립의, 사적인, 사설의
sit	앉다, 놓여 있다, 걸터앉다, 착석하다
news	뉴스, 소식, 보도, 신문, 정보
top	위, 최고인, 가장, 상위, 정상
scene	장면, ~계, 현장, 무대, 소동
marriage	결혼, 부부 관계, 혼인
step	조치, 단계, 밟다, 걸음, 계단
garden	정원, 가든, 원예를 하다
race	경주, 경기, 인종, 경쟁, 선거전
begin	시작하다, 발생하다, 착수하다, 출발하다
per	당, 일, 매, 마다
individual	개인의, 개별의, 개개의, 각기 다른
sitting	식사 시간, 회기, 앉아 있는
learn	배우다, 공부하다, 알다, 깨닫다, 습득하다
political	정치의, 정계의, 정당의, 정략의
difficult	어려운, 힘든, 쉽지 않다, 곤란한, 까다로운
bit	조금, 약간
speech	연설문, 연설, 말하기, 말, 발언
lie	거짓말, 눕다, 놓여 있다, 속이다, ~에 달려 있다
cast	배역, 투표하다, 던지다, 드리우다, 깁스
eat	먹다, 음식, 먹을 것, 식사, 식
authority	당국, 권한, 권위, 권위자, 권력
floor	의원, 층, 바닥, 마루, 발언권
ill	아픈, 나쁜, 잘못된, 좋지 않은, 고생하다
ways	거리, 형용사·명사에 붙여서 「방향」 「위치」 「양태」를 나타내는 부사를 만듦
original	원래의, 원본의, 최초의, 독창적인, 창작의
happiness	행복, 만족, 기쁨, 행운
produced	생산된, 제작, 만든, 배출, 나오다
summer	여름, 하계, 여름철, 여름날
provide	제공하다, 공급하다, 지급하다, 준비하다, 고려하다
study	연구, 공부, 조사, 학업, 전공하다
religion	종교, 신앙
picture	사진, 그림, 영화, 영상, 화면
personal	개인의, 자신의, 사적인, 인간적인, 자기의
watch	보다, 관람하다, 지켜보다, 시계, 감시하다
pleased	기쁜, 만족스러운, 반가운, 즐거운, 좋아하는
leaves	leaf의 복수형, 블루진
declared	선언된, 선포, 발표, 판결, 지정
hot	더운, 뜨거운, 매운, 인기 있는, 잘하는
understood	이해된다, 알았다, 의사소통했다
effort	노력, 작업, 활동
prepared	준비된, 대비된, 만들어진, 마련된, 각오된
escape	탈출하다, 피하다, 벗어나다, 도망치다, 면하다
attempt	시도하다, 노력, 기도하다, 계획하다, 미수
supposed	되어 있는, 해야 했다, 위한, 하려고 했다, 예정이었다
killed	취한
fast	빨리, 빠른, 단식일, 단식하다, 깊게
author	작가, 저자, 필자, 저술가
brown	브라운, 갈색
determined	결정된, 결심한, 결의, 생각, 작정
pain	고통, 통증, 아프다, 진통, 귀찮다
spring	봄, 스프링, 샘, 일어나다, 출신이다
drawn	draw의 과거 분사형, 긴장된, 굳은
beneath	아래에, 밑에, 지하에, 가치가 없는, ~의 이면에
talking	이야기, 말하는, 대화, 통화, 소리
turning	되다, 전환하다, 돌리다, 바꾸다, 변하다
century	세기, 100년
steps	도정, 행정, 노정
intended	의도된, 하려고, 계획된, 목적으로
soft	부드러운, 소프트한, 가벼운, 약한, 달콤한
straight	연속한, 똑바로, 곧장, 바로, 직선
likely	가능성 있는, 할 것 같은, 아마, ~할 듯한
corner	모퉁이, 구석, 코너, 궁지
trademark	트레이드마크, 상표, ~의 상표를 등록하다
justice	정의, 재판, 사법, 판사, 공정
simply	단순히, 간단히, 그저, 아주, 전혀
produce	~을 생산하다, 만들다, 제작하다, 만들어 내다, 제조하다
trust	신뢰, 믿음, 기업합동, 신탁, 맡기다
laugh	웃다, 웃음, 비웃다, 재미있어하다
forget	잊다, 깜빡하다, 무시하다, 망각하다, 놓고 오다
passage	통과, 통로, 구절, 경과, 통행
eight	여덟
closed	폐쇄된, 닫힌, 폐점의
ourselves	우리들, 우리 스스로
dress	입다, 옷, 드레스, 복장, 정장
passing	통과, 일시적인, 굉장히
terrible	끔찍한, 무서운, 좋지 않은, 엄청난, 약한
required	필요한, 한다, 요구, 필수인
medium	중간의, 중간, 매체
sake	위함, 이익
breath	숨, 냄새, 호흡, 숨결
wise	현명한, 지혜로운, 영리한
ladies	여성용 화장실
possession	소유, 재산, 영토
pleasant	즐거운, 좋은, 유쾌한, 쾌적한, 상냥한
perfectly	완벽하게, 매우, 완전히, 정확히, 더할 나위 없이
o'	of의 단축형, 아일랜드계의 성에 붙임
memory	기억, 추억, 메모리, 유산, 추모
usually	보통, 대개, 일반적으로, 늘, 평소
grave	무덤, 중대한, 심각한
fixed	고정된, 정해진, 수리된, 정지한, 일정한
modern	현대의, 근대의, 오늘날의, 모던
spot	장소, 위, 발견하다, 점, 관광지
troops	군대, 부대
rise	증가하다, 오르다, 상승하다, 늘다, 높아지다
break	깨다, 휴식, 부러지다, 헤어지다, 고장나다
fifty	50, 50개, 50의
island	섬, 도, 아일랜드
meeting	회의, 만남, 집회, 미팅, 충족하는
camp	캠프, 수용소, 진영, 훈련소, 야영하다
nation	국가, 나라, 국민, 민족
existence	존재, 현존, 생존, 생활, 실체
reply	대답하다, 답장, 응답, 회신하다, 응하다
sky	하늘, 상공, 날씨, 공기, 천체
touch	연락을 하다, 만지다, 터치, 감동시키다, 건드리다
equal	동등한, 평등한, 같은, 동일한, 공평한
fortune	재산, 행운, 운, 포춘, 부
shore	해안, 강화하다, 육지, 기슭
domain	완전 토지 소유권, 영토, 분야, 영역, 범위
named	이름의, 라고 불리는, 유명한, 지명된, 지정된
situation	상황, 사태, 상태, 입장, 경우
promise	약속하다, 공약하다, 유망, 전망, 장래성
degree	도, 학위, 급, 등급
middle	중앙의, 중간의, 중반의, 중세의, 중도의
winter	겨울, 동계
plan	계획하다, 예정, 구상, 플랜, 의도
spent	보냈다, 지출했다, 낭비된, 다 써버린
allow	~할 수 있게 하다, 허용하다, 허락하다
pale	창백해지다, 엷은, 연한, 안색이 안 좋은
conduct	실시하다, 수행하다, 행동하다, 시행하다, 지휘하다
running	달리는, 운영, 뛰는, 운행, 흐르는
religious	종교의, 신앙의, 독실한
surprise	놀라다, 놀라게 하다, 깜짝, 놀람, 기습하다
minute	분, 잠깐, 적은 양의, 의사록
roman	로마의, 로마인, 로만, 로마어
shot	발사, 슛, 시도, 촬영, 주사
lead	이끌다, 선두, 선도하다, 일으키다, 리드
move	움직이다, 이사하다, 옮기다, 조치, 이동하다
names	욕, 험담, 악담
stop	멈추다, 중단하다, 그만, 막다, 정지시키다
higher	높은, 더 ~한, 고등의, 이상의
et	명사에 붙여 「작은」의 뜻을 나타냄, 외계인, 동부표준시
threw	던졌다, 시구를 했다
worse	더 나쁜, 악화되어 있는
built	지어진, ~으로 만들어진, 제작된, 생산된, 건강한 체격의
spoken	말해 본, 구어의, 어조가 ~한
glass	유리, 잔, 안경, 컵, 렌즈
board	위원회, 이사회, ~판, 탑승하다, 보드
vain	보람없는, 헛된, 허영심이 강한
instance	예, 사례, 일례
safe	안전한, 무사한, 금고, 세이프의, 신중한
loss	손실, 잃음, 사상자수, 감소, 패배
doctor	의사, 선생, 박사
offer	제공하다, 제안하다, 제시하다, 지원하다, 드리다
class	수업, 계층, 강의, 반, 등급
complete	완성된, 완전한, 완료하다, 끝내다
access	접근, 이용, 접속, 출입
lower	낮추다, 내리다, 하부의, 줄다, 남쪽의
wouldn't	would not의 단축형
repeated	되풀이된, 자주 있는, 거듭되는
darkness	어둠, 암흑, 흑심
military	군사의, 군의, 군대의, 군부, 병역의
warm	따뜻한, 온난한, 준비를 하다, 데우다, 새로운
drink	마시다, 음료, 한 잔, 음주, 먹다
passion	열정, 흥미, 감정
physical	신체의, 물리의, 육체의, 건강진단, 몸의
example	예, 본보기, 사례, 모범, 선례
start	시작하다, 출발점, 출발하다, 처음, 선발
lying	lie의 현재 분사형, 거짓말하는, 허위의
keeping	일치, 조화, 준수
spite	불구하고, 원한, 앙심
shown	show의 과거 분사형
directly	직접적으로, 똑바로, 곧바로, 곧장, 즉시
james	제임스, 야고보
hart	수사슴, 하트, 잭의 스리카드
serious	심각한, 진지한, 정말, 중대한, 위험한
hat	모자, 직업, 아프리카 수면병
dog	개, 애완견, 강아지, 도그, 개고기
silver	은, 은메달, 실버
sufficient	충분한, 만족스러운
main	주요한, 주된, 메인, 중심적인, 주로 쓰이는
mentioned	언급된, 언급한
servant	공무원, 하인, 고용인, 봉사자
pride	자부심, 자랑, 자존심, 긍지, 프라이드
crowd	군중, 붐비다, 많음, 관객, 혼잡
train	훈련하다, 기차, 열차, 교육하다, 연습하다
wonderful	멋진, 훌륭한, 좋은, 놀라운, 행복한
moral	도덕의, 윤리의, 정신적인, 교훈적인, 도의의
instant	즉각, ~하자마자, 인스턴트의, 즉석의, 순간
associated	연관된, 관계가 있는, 연상되는, 연합된, 조합의
path	길, 경로, 도로, 방향, 궤도
greek	그리스의, 그리스어, 그리스인
meaning	의미, 뜻, 의미 있는, 중요성, 의도
fit	꼭 맞는, 어울리는, 건강한, 맞추다, 들어맞다
ordered	정연한, 질서바른, 정돈된
lot	많은, 매우, 훨씬, 큰, 부지
he's	he is 또는 he has의 단축형
enter	들어가다, 입장하다, 참가하다, 입력하다, 훈련시키다
rule	규칙, 규정, 통치하다, 지배하다, 법칙
sword	검, 칼
attack	공격하다, 발작, 비난하다, 덤벼들다, 폭행하다
seat	자리잡다, 자리, 좌석, 앉다, 의석
game	게임, 경기, 시합
health	건강, 보건, 건전
paragraph	단락, 문단, 절, ~항(項)
statement	발표, 말함, 진술, 대차표
social	사회의, 소셜, 사교적인, 사회주의의
refund	환불하다, 환급하다, 반환하다, 반품하다, 돌려주다
sorry	미안한, 죄송한, 유감스러운, 안됐다, 사과하는
courage	용기, 용감
grace	유예, 우아함, 은혜
official	관계자, 관리, 공식의, 당국, 공무원
dream	꿈, 꿈꾸다, 상상하다, 드림, 희망
worthy	가치 있는, 해볼만한, 훌륭한, 자격 있는
rock	록, 바위, 암석, 돌, 암벽
jack	잭, 잭으로 들어올리다, 소매 없는 가죽 상의
provided	제공된, 만약 ~이면, 규정된, 조건으로
special	특별한, 특수한, 스페셜, 임시의, 특이한
shook	흔들렸다, 저었다, 악수했다, 충격 받은
request	요청, 요구, 신청, 부탁, 청구
mighty	강력한, 힘센, 대단히, 거대한, 전지전능한
glance	흘끗 보다, 대충 훑어보다, 곁눈질, 스치다
movement	운동, 움직임, 동작, 이동, 변화
fee	요금, 금액, 사례금
share	공유하다, 나누다, 점유하다, 주식, 주가
expect	예상하다, 기대하다, 생각하다, 바라다, 기다리다
couldn't	할 수 없었다
spread	퍼지다, 확산되다, 퍼뜨리다, 번지다, 유포시키다
opposite	정반대의, 상대, 상반되는, 맞은편의, 서로 마주하는
glory	영광, 기뻐하다
twelve	열둘
space	우주, 공간, 스페이스, 동안, 장소
engaged	통화 중인, 바쁜, 사용 중인
peter	남자 이름, 금고, 점차 가늘어지다
wine	와인, 포도주, 술
ordinary	일반적인, 평범한, 보통의, 일상적인, 통상의
taste	맛보다, 맛, 취향, 먹다, 입맛
iron	철, 아이언, 쇠, 다리미
isn't	is not의 단축형
distribute	배포하다, 공급하다, 나눠주다, 분배하다, 기부하다
trade	무역, 거래, 통상, 교역하다, 시장
consider	고려하다, 여기다, 생각한다, 간주하다, 검토하다
greatly	크게, 몹시, 매우
accepted	받아들여지고, 받은, 합격한, 수용된, 수락한
forced	강요된, 강제적인, 어쩔 수 없는, 해야 하는
advantage	이점, 유리, 이익, 우위, 혜택
decided	결정한, 분명한, 단호한
using	사용
officer	경찰관, 장교, 담당관, 관리, 요원
rate	요금, 비율, 속도, 가격, 평가되다
clothes	옷, 세탁물, 의복, 의상, 옷가지
sign	계약하다, 서명하다, 체결하다, 신호, 징후
native	원주민의, 태생의, 토착의, 토박이의, ~원산의
judge	판사, 판단하다, 판결하다, 평가하다, 심사하다
difference	차이, 차액, 다른점, 변화, 구별
working	일, 효과가 있는, 일을 하고 있는, 취업한, 작업
anxious	불안한, 하고 싶어하는, 걱정스러운
marry	결혼하다, 혼인하다
captain	주장, 선장, 캡틴, 기장, 지도자
finished	끝난, 마쳤다, ~등, 완성된, 마무리된
extent	정도, 범위, 한도, 지역
curious	궁금한, 알고 싶은, 이상한, 신기한, 호기심이 강한
foreign	외국의, 대외적인, 이질의, 수입의, 타지방의
besides	~외에, 게다가, 그리고, ~말고는, ~제외하고
method	방법, 방식, 수단
excellent	훌륭한, 뛰어난, 좋다, 수의, 우수한
confidence	자신감, 신뢰, 신임, 확신, 신용
marked	두드러진, 현저한, 표식을 가진
jesus	예수 그리스도, 아이고
exactly	정확히, 그렇소, 바로, 확실히, 꼭
importance	중요성, 중대함, 소중함, 중점
finally	마침내, 마지막으로, 드디어, 결국, 결정적으로
bill	법안, 빌, 지폐, 청구서, 계산서
vast	광대한, 방대한, 거대한, 막대한
prove	증명하다, 입증하다, 밝혀지다, 드러나다, 판명되다
fancy	화려한, 근사한, 고급의
quick	빠른, 빨리, 신속한, 급한, 민첩한
yes	네, 그렇습니다, 그래, 맞아, 응
sought	seek의 과거·과거 분사형
prevent	막다, 예방하다, 방지하다, 못하게 하다, 금지하다
neck	목
liberty	자유, 리버티, 해방, 멋대로
interesting	흥미로운, 재미있는, 놀라운
legal	법적인, 법률상의, 합법적인
dry	마른, 말린, 건조한, 드라이, 가뭄의
serve	제공하다, 복무하다, 근무하다, 봉사하다, 대접하다
aside	별도로 하고, 방백, 곁에
pure	순수한, 순전한, 완전한, 순종의
concerning	~에 관하여
forgotten	forget의 과거 분사형
lose	잃다, 지다, 길을 잃다, 손해보다, 감소하다
possessed	홀린, 움직여진, 침착한
thrown	throw의 과거 분사형
evidence	증거, 근거, 흔적, 단서
distant	먼, 거리를 두는, 냉담한, 서먹서먹한, 원격의
michael	남자 이름, 대천사 미가엘, 천사장 미가엘
progress	진전, 발전, 진행, 진척, 진보
similar	비슷한, 유사한, 같은, 흡사한, 닮은
narrow	좁은, 줄이다, 편협한, 가는, 근소한
altogether	전적으로, 모두 함께, 합하여
building	건물, 건축, 빌딩
page	페이지, 쪽, 호출하다, 한 장
particularly	특히, 특별하게
knowing	아는 체하는, 지식, 빈틈없는
settled	안정된, 정착한, 고정된
holding	들고, 개최, 지주, 보유물, 막는
mountain	산, 거대한, 산에 사는
search	찾다, 검색하다, 수색하다, 구하다, 조사하다
sad	슬픈, 안타까운, 가슴아픈, 우울한, 애석한
sin	죄, 죄를 짓다
proud	자랑스러운, 자신감이 강한, 자부심이 강한, 당당한, 뽐내는
clearly	분명하게, 명확히, 밝게, 또박또박
price	가격, 가격표, 물가, 대가, 요금
ships	선박
thirty	30, 30분
sick	아픈, 병든, 환자의, 지겨운, 싫어지다
honest	정직한, 솔직한, 성실한, 정당한
shut	닫다, 폐쇄하다, 차단하다, 다물다, 감다
bank	은행, 뱅크, 강둑
fate	운명, 천명
dropped	처짐
judgment	판단, 심판, 판결, 결정, 의견
accept	받아들이다, 수용하다, 인정하다, 입학시키다, 응하다
removed	동떨어진, 격리된, 다른
forest	숲, 삼림, 산림
measure	대책, 조치, 측정하다, 평가하다, 법안
species	종, 종류, 인류
seek	찾다, 모색하다, 추구하다, 구하다, 노력하다
highest	가장 높은, 최고의, 많은
otherwise	그렇지 않으면, 다른, 아니면, 그 이외의
stream	강, 시내, 개울, 기류
honor	영광, 경의, 명예, 수여하다, 상
carefully	신중하게, 주의하여, 조심스럽게, 세심하게, 자세하게
ear	귀, 청각, 청력, 이삭
bread	빵, 생계
bottom	바닥, 하위, 아래, 밑바닥, 최하의
additional	추가의, 더, 또, 다른, 부가적인
aid	지원, 원조, 도움, 구호, 보조
q	영어 알파벳의 열 일곱째 자
choose	선택하다, 고르다, 선출하다, 원하다
agreed	합의된, 동의된, 하기로 했다, 약속했다, 찬성했다
animal	동물, 짐승, 야수
there's	there is, there has의 단축형
fully	완전히, 충분히, 전적으로, 완벽하게, 철저히
delight	기쁘게 하다, 즐겁게 하다, 기쁨, 기꺼이 ~하다
rights	권리, 인권, ~권, 저작권, 권한
amount	양, 되다, 금액, 액수, 달하다
obtain	얻다, 입수하다, 취득하다, 획득하다, 만족되다
tax	세금, 세, 과세하다
cross	건너다, 넘다, 횡단하다, 십자가, 엇갈리다
thick	두꺼운, 두께, 진한, 짙은, 굵은
points	전철기
stranger	낯선 사람, 모르는 사람, 이방인, 남
woods	숲, 삼림, 우즈 호(Lake of the Woods)
dare	감히 ~하다, 도전, 용기
grow	성장하다, 자라다, 증가하다, 크다, 늘다
creature	생물, 생명체, 동물, 창조물
hung	걸었다, 전화를 끊었다, 매달렸다, 분투했다, 고개를 떨구다
rain	비, 비가 오다, 비가 내리다, 강우, 빗물
false	거짓의, 허위인, 잘못하여, 틀린, 부정의
tall	키, 키가 큰, 높은, 높이가 ~인, 긴
gate	문, 게이트, 탑승구, 입구, 개찰구
quietly	조용히, 살며시, 얌전하게, 은밀히
surface	표면, 겉으로 드러나다, 지표의, 수면
freely	아낌없이, 자유롭게, 기꺼이
holy	성스러운, 신성한, 세상에나
blow	타격, 불다, 울리다
july	7월, 3분기
fashion	패션, 유행, 옷, 방식, 관습
report	보고, 보고서, 보도, 발표하다, 기록하다
coast	해안, 연안, 해변
daily	매일의, 일상적인, 데일리, 날마다
file	소송을 제기하다, 파일, 서류, 기록, 정리하다
shoulder	어깨, 책임을 지다, 갓길
surprised	놀란
distribution	분배, 유통, 배포, 배급, 분포
royal	왕실의, 로열, 왕족
song	노래, 곡, 노래 부르기, 발라드, 가곡
wealth	부, 재산, 부유함, 자원
comfort	위로, 편안함, 위안, 안락, 달래다
failed	실패한, 결함이 있는, 파산한
freedom	자유, 석방
peculiar	특이한, 특유한, 특별한
anyone	누군가, 모든 사람, 아무도
advance	진출, 발전, 발달, 나아가다, 진보
gentle	온순한, 부드러운, 점잖은, 친절한, 다정한
surely	분명히, 확실히, 물론, 틀림없이, 정말로
secure	확보하다, 안전한, 확신하는, 보장하다, 지키다
desired	훌륭한, 바랐던, 희망했던
grass	잔디, 풀, 목장
touched	감동한, 마음이 움직인, 노망한
draw	그리다, 끌다, 긋다, 받다, 만들다
stage	무대, 단계, 전개하다, 무대에 올리다, 연극
portion	부분, 일부, 양, 인분, 분배하다
opening	개막, 여는, 개방하는, 첫, 오프닝
june	6월
fish	물고기, 낚시하다, 생선, 어업의
tongue	혀, 말, 입, 언어
capital	수도, 자본, 자금, 자산, 대문자
angry	화난, 성난, 격렬한
growing	증대하는, 성장하고 있는, 커지는
carriage	마차, 객차, 운송
weather	날씨, 기상, 기후, 일기, 극복하다
breast	가슴, 유방, 가슴살
presently	현재, 곧, 지금, 최근
snow	눈, 눈이 내리다
david	데이빗, 다비드, 다윗
necessity	필요성, 필수품
practice	연습하다, 관습, 행위, 실천하다, 실행하다
claim	주장하다, 말하다, 요구하다, 차지하다, 제기하다
hast	have의 2인칭·단수·직설법·현재형
education	교육, 훈련, 교양
sharp	날카로운, 급격한, 샤프, 뾰족한, 정각에
prince	왕자, 프린스, 세자, 태자, ~공
group	그룹, 단체, 집단, 무리
robert	남자 이름, 로버트
played	play(놀다)의 과거형, 놀았다
throughout	~내내, ~동안, 통하여, 도처에, 완전히
pity	유감, 연민, 불쌍한, 동정, 애석한
expense	비용, 지출, 경비, 희생
yours	당신의 것, 당신의, 네 것
million	100만, 무수한, 수백만
add	덧붙이다, 더하다, 추가하다, 포함시키다, 증가하다
pray	기도하다, 기원하다, 바라다
taught	가르쳤다, 배웠다
tired	피곤한, 싫증난
leading	선도적인, 이끄는, 주요한, 최고, 대표적인
kill	죽이다, 살해하다, 사망하다, 목숨을 앗아가다, 자살하다
shadow	그림자, 그늘, 미행
companion	친구, 동료, 동반자, 반려, 벗
weight	무게, 체중, 살, 웨이트, 비중
mass	대량의, 미사, 대중의, 집단의, 질량
established	설립된, 정해진, 자리를 잡은, 정착된, 시작된
gray	회색, 창백한, 백발이 되다
brave	용감한, 무릅쓰다, 용기
thin	얇은, 마른, 묽은
satisfied	만족한, 납득한, 충족된
check	확인하다, 수표, 점검하다, 검사, 견제
virtue	미덕, 덕목, 덕행, 군자
golden	황금의, 골든, 가장 좋은, 절호의
numerous	수많은, 다양한, 다수의
frequently	자주, 종종, 빈번히, 잦은, ~하는 경우가 많다
famous	유명한, 잘 알려진, 뛰어난, 훌륭한, 멋진
telling	효과적인, 효험이 있는, 말하기
powerful	강력한, 파워풀한, 힘있는, 센, 유력한
alive	살아 있는, 생기에 넘치는, 이 세상의, 계속하여, 생생한
national	국가의, 전국민의, 국립의, 전국의, 국내의
weak	약한, 취약한, 약세, 침체된, 허약한
divine	신의, 신성한, 디바인, 점치다
material	자료, 물질의, 재료, 소재, 원료
principal	교장, 주요한, 주된, 원금
gathered	눈살을 찌푸린, 주름을 잡은
frank	프랭크, 솔직한, 터놓은
valley	계곡, 유역, 골짜기
guess	~인 것 같다, ~라고 생각하다, 추측하다, 맞히다, 짐작하다
finding	찾아내는, 밝히는, 결과, 알게 되다
yellow	노란, 노란색, 황색, 황열병, 황금색
heat	열, 뜨거워지다, 가열하다, 난방, 더위
remains	유해, 유골, 유적, 유물, 화석
bent	열중하여, 구부러진, 화내다, 결심한, 정직하지 못한
seized	소유한, 점유한
guard	경비원, 보호하다, 경계, 가드, 막다
equally	똑같이, 마찬가지로, 동등하게, 평등하게, 균등하게
naturally	자연스럽게, 당연히, 선천적으로, 본래, 저절로
box	상자, 박스, ~함, 권투, 틀
remarkable	놀라운, 주목할 만한, 훌륭한, 괄목할 만한, 두드러진
moon	달, 위성
slight	약간의, 조금, 사소한, 작은, 가벼운
style	스타일, 방식, 형식, 모양, 양식
pointed	지적하는, 뾰족한, 강조한, 겨누는
windows	미국 마이크로소프트사가 개발한 PC용 OS의 총칭, 윈도우즈
crossed	십자를 그은, 혼선인, 혼신 상태인
louis	XIV 루이 14세, XVI 루이 16세
ain't	am not의 단축형, have not의 단축형
evidently	분명히, 명백하게
principle	원칙, 원리, 법칙, 신념, 교리
immediate	즉각적인, 당장, 즉시, 시급한, 직접적인
willing	기꺼이 하는, ~할 의사가 있는, 적극적인, 알맞은
consequence	결과, 중요성, 결말
richard	남자 이름, 리처드 1세, Richard Ⅱ, 2세
paul	남자 이름, Paul Ⅲ, Saint, 성바울
season	시즌, 계절, 제철, 시기, 적기
science	과학, 사이언스, 학문
tender	제출하다, 부드러운, 다정한, 입찰하다, 화폐
worked	가공한, 세공한, 가공된
grown	성장한, 어른의, 커진, 자란, 증가한
interested	관심있는, 흥미있는, 마음있는, 생각있는, 싶은
quarter	분기, 1/4, 25센트, 쿼터, 3개월
midst	한가운데, ~하는 중에 있다, 한창때, 중앙
advanced	선진의, 진보한, 앞선, 진출한, 고등의
apparently	분명히, 명백히, 확실히
bore	지루하게 하다, 따분하게 하다, 땅굴을 파다, 구멍을 뚫다
active	활동적인, 적극적인, 활발한, 현역의, 능동적인
aware	알고 있는, 인식하는, 깨달은, 의식하는
thomas	남자 이름, 성 도마, ~을 성희롱 혐의로 고발하다
uncle	삼촌, 아저씨
list	목록, 명단, 등재되다, 리스트, 상장하다
dangerous	위험한
august	8월
calm	진정시키다, 차분한, 침착한, 조용한, 안정
genius	천재, 비범한, 영재
sacred	신성한, 성~, 성스러운, 종교적인
kingdom	왕국, 왕조
entire	전체의, 내내, 완전한, 전반적인
popular	인기 있는, 유명한, 대중의, 국민의
unknown	알려지지 않은, 알 수 없는, 미지의, 미상의, 무명의
nice	좋은, 멋진, 친절한, 훌륭한, 반가운
habit	습관, 버릇, 관습, 경향, 의복
spanish	스페인의, 스페인어, 스페인 사람
familiar	익숙한, 친숙한, 낯익은, 잘 아는
reader	독자, 리더, 읽는 사람, 독서가
direct	직접의, 감독하다, 지시하다, 연출하다
handsome	잘 생긴, 멋진, 상당한
you'll	you will, you shall의 단축형
actually	사실은, 실제로, 정말로
king	왕
posted	정통한, 지위 있는, 지위가 있는
approach	접근하다, 접근법, 방법, 다가오다, 육박하다
washington	미국 정부, 워싱턴, 워싱턴 주, 워싱턴 호
hearing	청력, 듣기, 청각
increased	증대한
walking	걷는, 보행용의, 걷기
twice	두 번, 두 배, 다시
throw	던지다, 버리다, 가하다, 파티를 열다, 넣다
intellectual	지적인, 지식인, 지성인, 인텔리
appointed	임명된, 정해진, 지정된
wisdom	지혜, 교훈, 학문
truly	진정, 정말, 사실대로, 진심으로, 참으로
numbers	수치, 숫자, 번호, 많은, 전화번호
priest	신부, 사제, 성직자, 목사, 승려
wounded	상처를 입은, 부상자, 부상당한
sorrow	슬픔, 비통, 애도, 울적함, 유감
drive	운전하다, 차로, 몰다, 가다, 드라이브
fault	잘못, 결점, 탓, 흠, 실수
palace	궁전, 왕실
affair	문제, 일, 사건, 정사, 행사
contact	연락, 접촉, 콘택트 렌즈, 교제, 시선을 마주치다
distinguished	저명한, 뛰어난, 차별화된, 품위 있는, 뚜렷한
station	역, 정거장, 방송국, 주둔하다, 기지
beat	이기다, 물리치다, 때리다, 비트, 뛰다
distributed	분포된, 광범위한, 분산된
e	영어 알파벳의 다섯째 자
listen	듣다, 귀를 기울이다, 경청하다, 잘 들어, 청취하다
italy	이탈리아
fool	바보, 속이다, 어리석은, 놀리다
hurt	다치다, 해치다, 아프다, 타격, 상처
express	표현하다, 나타내다, 발표하다, 고속의, 속달
favour	찬성하다, 주다, 부탁, 유리하다, 유리
height	키, 높이, 정점, 고도
size	크기, 규모, 사이즈, 면적, 몸집
edge	우위, 가장자리, 끝, 모서리, 경계
task	일, 과제, 업무
nine	아홉
sympathy	동정, 공감
burst	터지다, 터뜨리다, 폭발하다, 분출하다, 무너지다
putting	퍼팅
dressed	입었다, 복장, 옷차림
lifted	술이 거나하게 취한
suffer	겪다, 고통을 받다, 입다, 앓다, 고생하다
noise	소음, 소리, 시끄러움, 소란, 잡음
smiling	방긋거리는, 환한, 미소하는
rode	탔다, 말려 올라갔다, 탑승했다, 기여했다, 타고 달렸다
farther	더 멀리, 더 나아가서, 더욱, 그 이상의
literature	문학, 문예, 인쇄물, 문헌, 조사 보고서
vessel	선박, 배, 혈관, 물관
affection	애정, 사랑, 애착
suffering	고통을 겪는, 고생하는, 시달리는, 앓고 있는
flesh	살, 고기, 신체, 육체, 피부
advice	조언, 충고, 도움, 권고, 지시
grand	웅장한, 위대한, 원대한, 위엄 있는
carrying	들다, 다니다, 옮기는, 운반, 가지고
legs	다리
spain	스페인
post	~후에, 올리다, 게시하다, 직, 기록하다
collection	전시회, 컬렉션, 수집, 수거, 모음집
empty	빈, 비우다, 없어지다, 없는, 공허한
rank	차지하다, 오르다, 자리잡다, 계급, 랭크
storm	폭풍, 습격하다
imagine	상상하다, 생각하다, 짐작하다
wore	입었다
admitted	인정된, 시인, 말하다, 합격, 들어오다
pocket	주머니, 호주머니, 포켓, 자금
arrival	도착, 등장, 탄생
imagination	상상, 착각, 창의성
driven	drive의 과거 분사형, 의욕이 넘치는, ~주도의
loud	큰 소리로, 큰, 시끄러운, 화려한
sentence	문장, 선고, 처벌, 말, 글
lovely	사랑스런, 멋진, 귀여운, 아름다운, 예쁜
extraordinary	뛰어난, 특별한, 임시의, 엄청난, 이례적인
november	11월
december	12월, 4분기, 섣달
happen	일어나다, 발생하다, 생기다, 벌어지다, 우연히 ~하다
absence	없음, 결석, 공백, 부족
breakfast	아침, 아침식사, 조식
population	인구, 사람들, 개체군, 주민, 모집단
thank	감사하다, 고맙습니다, 고마움, 사의, 치사
series	시리즈, 일련, 연작, 계속해서, 경기
laughing	웃음, 명랑한, 즐거운 듯한
address	주소, 연설하다, 이야기하다, 부르다
relief	안도, 구조, 다행, 완화, 편안함
bird	새, 조류
owner	주인, 소유자
impression	인상, 생각, 흉내
satisfaction	만족, 충족
coat	코트, 칠하다, 외피, 외투, 도금
prepare	준비하다, 대비하다, 마련하다
shape	모양, 컨디션, 형태, 몸매, 상태
birth	탄생, 출생, 태어남, 출산, 낳다
rapidly	급속히, 빠르게, 급격히, 신속히, 순식간에
smoke	흡연, 담배를 피우다, 연기, 훈제하다, 화재
machine	기계, 기구, 머신
content	내용, 콘텐츠, 만족하는, 함유량, 목차
consideration	고려, 배려, 생각, 이해, 숙고
regular	정규의, 정기의, 규칙적인, 보통의, 정례의
moving	움직이는, 감동시키는, 감동적인
wholly	완전히, 전적으로
teeth	치아
busy	바쁜, 분주한, 붐비다, 통화 중인
burning	불타는, 연소, 화끈거리는, 뜨거운, 현안
shame	부끄럽다, 수치심, 안타깝다, 창피, 유감이다
quality	질, 품질, 자질, 고급의, 특성
bay	만(灣), 베이, 월계수
discover	발견하다, 알다, 밝히다, 찾다, 나타나다
inside	내부, 안쪽, ~안에
brain	뇌, 두뇌, 머리, 브레인
soil	흙, 땅, 더럽히다
completely	완전히, 전적으로, 완벽하게, 모두, 철저히
message	메시지, 메모, 말씀, 전갈, 교훈
ring	반지, 울리다, 전화하다, 링, 고리
resolved	결심한, 결심이 굳은, 단호한
calling	직업, 천직, 소집
phrase	말, 구절, 문구, 어구, 숙어
mention	언급하다, 말하다, 거론하다, 이야기하다
square	광장, 평방, 사각형, 네모, 제곱
pair	짝지어주다, 한 쌍, 2인조, 한 벌
won	원, 얻었다, 이겼다, 수상했다, 달성했다
title	제목, 우승, 타이틀, 선수권의, 명칭
understanding	이해, 지식, 합의, 공감
Sunday	일요일
fruit	과일, 결과, 열매
mad	화난, 미친, 미치광이, 열광한
included	포함된, 들어간, 수록, 둘러싸인, ~을 포함한
tea	차, 다과회
falling	떨어지는, 내리는, 비가 올 듯한
absolutely	절대적으로, 전혀, 완전히, 물론, 정말로
slow	느린, 늦추다, 늦은, 늦어지다, 천천히
bearing	담긴, 갖다, 관련, 출산, 결실을 거두다
mercy	자비, 머시, ~에 따라, 은총
explain	설명하다, 알려주다, 해명하다, 털어놓다, 확실히 하다
contain	들어있다, 포함하다, 담다, 함유하다, 담고 있다
grief	슬픔, 재난
soldier	군인, 병사, 병력, 전사
wasn't	was not의 단축형
countenance	묵인하다, 용모
previous	이전의, 앞선, 먼저의, 예비의
explanation	설명, 해명, 해석
welcome	환영하다, 맞이하다, 환대하다
prayer	기도, 기원, 기도문
germany	독일
belief	믿음, 신념, 생각, 소신, 신조
informed	견문이 넓은, 세련된, 정보에 근거한
poetry	시, 운문
constant	지속적인, 계속되는, 끊임없는, 일정한, 부단한
buy	사다, 구입, 매수하다, 소비, 얻다
final	결승전, 최종의, 마지막의, 결정적인, 기말 시험
faithful	충실한, 독실한, 신의 있는, 헌신적인
ride	타다, 달리다, 극복하다, 편승하다, 실어나르다
policy	정책, 제도, 방침, 보험증서, 규정
supper	저녁 식사, 만찬, 야식
drawing	그림, 도면, 발행
excitement	흥분, 즐거움, 신이 나서, 흥미, 행사
dying	죽어가는, 사망, 사라져 가는, 마지막의, 말기의
demand	요구하다, 수요, 까다롭다, 요청하다
fighting	싸우는, 전투적인, 맞서다, 애를 쓰다
fields	필즈, 영국의 여성 가수·코미디언
drove	drive의 과거형, 가축 떼, 대군중
upper	위의, 상위의, 상류의
sum	돈, 합계
philip	남자 이름
motion	발의, 모션, 동의, 움직임, 동작
assistance	지원, 도움, 원조, 보조, 조력
forty	40
april	4월
edward	남자 이름, 에드워드
kindly	부디 ~해 주세요, 친절하게, 호의적으로
dignity	존엄, 품위, 위엄
catch	잡다, 받다, 걸리다, 적발하다, 체포하다
october	10월
seated	좌부가 ~인, 엉덩이가 ~의, 뿌리가 ~인
amongst	among 보다 문어적인 표현
current	현재의, 현행의, 지금의, 해류, 전류
bitter	쓴, 씁쓸한, 쓰라린, 쓴맛, 신랄한
possibly	어쩌면, 어떻게, 아마, 혹시
slave	노예, 노예 제도의, 혹사당하다
separate	개별적인, 분리하다, 별거하다, 구분하다, 흩어지다
loose	느슨해지다, 풀다, 헐거운, 엉성한, 자유로운
text	글, 문자, 책, 텍스트
receiving	받는, 수신의, 받기
worst	최악의, 가장 나쁜
sold	팔았다, 판매했다
don	명사, 거물, 입다
credit	신용, 학점, 인정하다, 공, 채권
chosen	선택된, 선발된, 뽑힌
terror	테러, 공포, 두려움
features	특징, 용모, 특색으로 하다
fond	좋아하는
control	통제하다, 지배하다, 관리하다, 조절하다, 규제하다
capable	가능성있는, 능력있는, 가능한, 할 수 있는, 유능한
fifteen	열다섯
doesn't	does not의 단축형
firm	회사, 기업, 업체, 확고한, 강경한
superior	우수한, 상사, 위의, 더 나은
cruel	잔인한, 잔혹한, 모진, 무참한
spiritual	정신의, 영적인, 종교적인, 영혼의, 숭고한
harry	약탈하다, 남자 이름, 침략하다
splendid	화려한, 훌륭한, 멋진, 눈부신, 뛰어난
proof	증거, 증명, 입증
pressed	~에 궁하여, ~이 절박하여, 평평해진
sooner	선점 이주자, 선수치는 사람, 미국 Oklahoma주 주민의 별명
join	참여하다, 가입하다, 합치다, 만나다, 잇다
process	과정, 절차, 처리, 가공하다, 공정
crime	범죄, 죄, 죄악
dust	먼지, 가루, 황사, 모래, 티끌
instantly	즉시, 곧바로, ~하자마자, 순식간에
relation	관계, 관련, 연관, 친척
concerned	우려하는, 관련된, 신경쓰는, 관심을 가진
deeply	깊이, 몹시, 정말, 깊숙이, 심도 있게
practical	실용적인, 실제적인, 실질상의, 현실적인
colour	색깔, color
sing	노래하다, 부르다, 지저귀다
destroy	파괴하다, 파멸시키다, 훼손하다, 파기하다, 손상시키다
anger	분노, 화, 분개, 노여움
distributing	분배하는, 배급하는, 분배의
increase	증가하다, 늘리다, 인상되다, 확대하다, 상승하다
nose	코, 후각
friendly	친화적인, 우호적인, 친절한, 다정한, 우정어린
entrance	입구, 들어가기, 입학, 현관
admit	인정하다, 시인하다, 허가하다, 입원시키다, 승인하다
supply	공급하다, 물품, 비축물자
clean	깨끗한, 청소하다, 맑은, 치우다, 지우다
useful	유용한, 쓸모 있는, 도움이 되는, 유익한, 실용적인
yesterday	어제, 최근, 과거, 바로 얼마 전에, 요사이
delicate	섬세한, 민감한, 미묘한, 정교한, 허약한
fail	실패, 실패하다, 못하다, 없다, 떨어지다
continue	계속하다, 지속시키다, 이어지다, 아직도, 연기하다
remove	제거하다, 없애다, 삭제하다, 치우다, 벗다
addressed	주소를 쓰다
choice	선택, 결정, 선정, 종류
huge	큰, 엄청난, 거대한, 막대한, 성대한
needs	필요, 해야 한다, 요구, 수요, 부족
wear	입다, 쓰다, 옷, 착용하다, 끼다
blind	시각장애의, 맹목적인, 맹인의, 장님의, 블라인드
unable	~할 수 없는, ~하지 못하는, 불가능한, 무능한
cover	덮다, 부담하다, 가리다, 표지, 취재하다
double	2배의, 두 배의, 2중의, 더블의, 갑절
victory	승리, 성공
dozen	12개, 수십, 1다스
constantly	계속, 끊임없이
level	수준, 정도, ~급, 높이, 레벨
india	인도, 인도 반도, (약어)Ind.
release	발표하다, 개봉하다, 출시하다, 발매하다, 공개하다
rough	거친, 힘든, 대강의
fly	날다, 비행하다, 파리, 빠르다, 비행기를 타다
praise	칭찬하다, 찬사, 칭송하다, 높이 평가하다, 찬양하다
devil	악마, 데블, 어려운, 도대체, 마귀
ahead	앞서, 앞에, 미리, 빠르게
smith	금속 세공인
connected	일관성 있는, 관련된, 결합된
gain	얻다, 증가하다, 이익, 획득하다, 달성하다
addition	추가, 덧셈, 증축, 등재
committed	헌신적인, 빠져 있는, 기울어 있는
chamber	상공회의소, 방, ~실(室), 실내악의, (의회의) ~원(院)
notes	자연 개구부 수술
italian	이탈리아의, 이탈리아어, 이탈리아인
gradually	점차적으로, 점진적으로, 점점, 서서히
acquaintance	아는 사람, 인물, 만남, 친지
bought	샀다, 구입했다, 장만했다
mission	임무, 대사관, 계획, 미션, 사명
sacrifice	희생, 제물
mistake	실수, 잘못, 착각, 오해
exercise	운동, 훈련, 행사, 행동, 발휘하다
conscience	양심, 도덕심, 의식
based	바탕으로, 기반으로, 근거한, 따라, 연고
car	차, 자동차, 승용차
buried	bury의 과거·과거 분사형, 종신형에 복역하고 있는
theory	이론, 견해, 가설
nobody	아무도 ~않다, ~하는 사람이 없다, 하찮은 사람
minister	장관, 목사, 성직자
closely	긴밀히, 면밀하게, 유심히, 가까이, 깊은
energy	에너지, 힘, 정력, 활동력, 능력
dick	탐정, 형사, 놈
bare	노출된, 드러내다, 극소량의, 벌거벗은, 단순한
fought	fight의 과거·과거 분사형
partly	부분적으로, 일부, 어느 정도는, 때론, 조금은
mistress	정부, 연인
hate	싫어하다, 미워하다, 증오하다, 질색이다, 마음에 안들다
arose	arise의 과거형
color	색, 색깔, 색상, 컬러, 색칠하다
lake	호수, 연못
safety	안전
provisions	식량, 비상식량
description	설명, 묘사, 기술, 서술
asleep	잠들어, 조는
centre	센터, 중심, 중앙
faint	기절하다, 희미한, 거의
escaped	도망친, 달아난, 탈주한
careful	조심스러운, 주의깊은, 철저한, 신경을 쓰는
enjoy	즐기다, 누리다, 즐겁게, 즐거운 시간을 갖다
drop	하락, 떨어지다, 내리다, 그만두다, 떨어뜨리다
brilliant	뛰어난, 훌륭한, 찬란한, 멋진, 놀라운
brief	보고서, 짧은, 잠시, 간단한, 개요
worship	숭배, 예배, 흠모, 신앙
goods	상품, 물건, 물품, 물자, 재화
tale	이야기, 소설
skin	피부, 가죽, 껍질, 표피
roof	지붕, 옥상, 천장
grey	회색, 그레이
highly	매우, 높이, 고도로, 가장, 심각한
crown	왕관, 크라운, 관, 국왕
castle	성, 저택
excited	흥분한, 신이 난, 들뜨다, 기대하는, 열광하는
throne	왕위, 왕좌, 즉위
stated	공인된, 정기의, 일정한
despair	절망, 단념하다
ease	완화하다, 덜어주다, 편해지다, 쉬움, 느슨해지다
attached	덧붙여진, 첨부된, 달라붙은
total	총~, 전체, 완전한, 합계
kindness	친절, 호의
mile	마일, 먼 거리
circle	원, 서클, 돌다, 사회, 그룹
dull	지루한, 둔한, 따분한, 침체한, 무딘
extreme	극단적인, 극심한, 극도의, 지나친, 과격한
intention	의도, 의사, 의지, 의향, 취지
prison	감옥, 교도소, 수감, 수용소, 형무소
term	임기, 말하다, 용어, 계약조건, 기간
assured	보증된, 자신이 있는, 대담한
hidden	감춰진, 숨은, 비밀의, 남모르게
thoroughly	철저하게, 완벽하게, 아주, 깨끗하게
cup	컵, 잔
member	일원, 회원, 멤버, 의원, 단원
civil	시민의, 민간의, 민사의, 예의 바른, 친근한
apply	적용하다, 지원하다, 신청하다, 바르다, 해당되다
labor	노동, 근로, 노력, 출산, 진통
everywhere	어디나, 모든 곳, 도처, 여기저기
intelligence	정보, 지능, 첩보, 지성, 지적
strike	파업하다, 공격하다, 타격, 치다, 스트라이크
fairly	꽤, 공정하게, 공평하게, 완전히, 적절하게
comply	따르다, 지키다, 응하다, 동의하다
haven't	have not의 단축형
event	행사, 사건, 대회, 경기, 이벤트
gently	부드럽게, 천천히, 살며시, 조용히, 친절하게
connection	연결, 관련, 관계, 접속, 연줄
protection	보호, 경호, 방지, 비호
conscious	의식한, 의식적인, 의식이 있는, 알고 있는
edition	판, 전발행 부수, 1회분
directed	지령된, 지도된, 관리된
pulled	뽑았다, 꺼냈다, 당겼다, 떠났다, 뺐다
flight	비행, 비행기, 항공편, 여행, 비상
evident	분명한, 명백한, 생생한
weary	지친, 싫증나는, 지루한
couple	부부, 커플, 결혼하다, 두, 더
variety	다양, 여러종류, 여러 가지, 버라이어티, 갖가지
whilst	while, until
volume	권, 양, 볼륨, 소리, 부피
custom	세관, 관습, 문화, 풍습, 맞춤의
apart	떨어진, 분해하는, 분리된, 구별되는, 따로
bow	인사하다, 활, 굴복하다, 허리를 굽히다, 나비 넥타이
awful	끔직한, 지독한, 심한, 이상한, 엄청난
everybody	모든 사람들, 모두, 누구나, 다들, 여러분
labour	노동
asking	구함, 물어봄, 질문
lover	애호가, 사랑하는 사람, 연인, 정부
showing	상영, 전시, 외관
suit	정장, 어울리다, 옷, 소송
becoming	어울리는, 알맞은, 생성
composed	차분한, 침착한, 작성된
lest	~하지 않을까, ~하지 않도록
singing	노래, 노래하는, 창가
eager	싶다, 열망, 열심인
precious	소중한, 귀중한, 중요한, 귀여운
require	필요하다, 요구하다, 규정하다, 신경쓰다, 걸리다
meat	고기, 육류, 육식, 살코기
whenever	~할 때마다, ~하면, ~할 때는 언제나
milk	우유, 모유, 젖, 이용하다
dogs	(英속어) 그레이하운드 경주
successful	성공한, 잘된, 합격한
vision	비전, 시력, 보이기, 시야, 전망
rare	드문, 희귀한, 매우, 보기 드문, 설구워진
granted	당연히, 받은, 부여된, 허가, 승인
raise	올리다, 인상, 높이다, 오르다, 제기하다
egypt	이집트
cousin	사촌, 조카
you've	you have의 단축형
development	개발, 발전, 발달, 진전, 전개
arthur	아서왕
obs	생체 계측 시스템, obscure, observation
cool	멋진, 시원한, 식히다, 좋다, 침착한
trial	재판, 시험, 실험, 시도
learning	배움, 학습, 교육, 공부, 학문
bridge	다리, 교량, 브리지, 메우다, 육교
abroad	해외에, 외국에, 널리
devoted	헌신적인, 바쳐진, 전념하는, ~ 을 다룬, 사랑하는
paying	돈이 벌리는, 수지맞는, 지불하는
literary	문학의
writer	작가, 저자, 기자, 작곡가
fn	각주, ~에 각주를 달다, 보충
israel	이스라엘, 이스라엘인, 유대인
interrupted	가로막힌, 중단된, 방해된
stock	주식, 증권, 재고, 스톡
dreadful	무서운, 가혹한, 매우, 불쾌한
female	여성의, 여자의, 암컷의
protect	보호하다, 지키다, 막다, 비호하다
accustomed	익숙한, 적응된, 받는
virginia	버지니아, 미국 대서양 연안의 주, (약어)Va., VA
type	종류, 유형, 타자, 양식, 타입
recognized	인정받은, 알려진, 인식된, 받아들여진
salt	소금
innocent	죄 없는, 순수한, 선량한, 단순한
temper	성격, 화
plenty	많은, 충분하게, 풍부한, 넉넉함, 풍요
pope	교황
avoid	피하다, 회피하다, 막다, 자제하다, 예방하다
hurried	서두르는, 매우 급한, 재촉받은
favor	찬성하다, 주다, 부탁, 유리하다, 유리
mental	정신의, 지적인, 마음의, 관념적인
attitude	태도, 자세, 사고 방식, 몸가짐
admiration	존경, 감탄, 칭찬, 찬양
anxiety	불안, 걱정, 염려, 근심, 긴장
queen	여왕, 왕비, 퀸, 왕후
teach	가르치다, 알려주다, 배우게 하다, 훈련하다, 가르침을 받다
count	세다, 중요하다, 포함시키다, 계산하다, 생각하다
curiosity	호기심, 큐리오시티
solemn	엄숙한, 근엄한, 장엄한, 진지한
dance	춤, 추다, 댄스, 무용
hotel	호텔
wicked	사악한, 약한, 심하게
fled	flee의 과거·과거 분사형
guns	이두박근
fill	채우다, 가득하다, 가득 차다, 신청서를 작성하다, 메우다
visible	보이는, 가시의, 눈에 띄는, 관찰되는
younger	더 젊은, 더 어린, 동생인, 젊은이, 아래의
guide	안내하다, 가이드, 지도하다, 인도하다, 유도하다
earnest	진지한, 성실한, 솔직한
actual	실제의, 사실상의, 현재의, 진짜의
prisoner	죄수, 포로, 수감자, 재소자, 범죄자
miserable	비참한, 불행한, 절망적인
lad	젊은이, 친구, 소년
harm	해치다, 피해를 입히다, 손해, 훼손하다, 불편
irish	아일랜드의, 아일랜드인, 아이리시
utterly	완전히, 철저히, 전혀
shop	쇼핑하다, 가게, 상점, 매장, 소매점
stairs	계단
pardon	사면, 특사, 용서, 실례
gay	동성애자, 동성애의, 게이
beg	구걸하다, 부탁하다, 탄원하다
seldom	거의~않다, 좀처럼, 드물게
record	기록적인, 기록하다, 최고의, 녹음하다, 음반
fat	지방, 뚱뚱한, 살찐, 비만한, 기름
sand	모래, 사막, 모래사장, 사포질하다
violent	폭력적인, 격렬한, 심한
september	9월
worn	입던, 낡은, 지쳐버린
ireland	아일랜드
flat	납작한, 평면, 펑크난, 아파트, 한 푼 없는
departure	출발, 떠남, 사임, 벗어남
delivered	~인도의, 배달료 포함의
gift	선물, 재능, 증여, 증정
ruin	망치다, 폐허, 유적, 파멸
skill	기술, 실력, 솜씨, 기능
cattle	소 (집합적으로 복수 취급 a cattle, cattles라고는 하지 않음)
equipment	장비, 기기, 설비, 기술, 부품
temple	절, 사원, 교회
earlier	앞서는, 이전에, 더 일찍, 좀 더 빨리
license	면허, 허가, 라이센스, 자격증, 번호판
en	반각
consent	동의하다, 승낙하다, 이구동성으로
sufficiently	충분히
wound	상처, 고통
laughter	웃음, 웃는, 웃음소리
contained	침착한, 억제하는, 조심스러운
scattered	뿌려진, 흩어져 있는, 산만한
whence	출처, 거기서부터 ~하는 바의, ~하는 바
rushed	아주 급하게 해결된, 서두르다, 달려들다
chiefly	주로, 우두머리의
bold	대담한, 뻔뻔스러운, 용감한
anywhere	어디든지, 어딘가에, 아무데도, 어느 곳이든
witness	보다, 목격자, 증언하다
foolish	어리석은, 바보 같은
kitchen	부엌, 주방
sell	팔다, 판매하다, 매각하다, 매도하다, 매출
anybody	누군가, 이렇다할 사람, 아무나
self	자기, 자신, 자아
extremely	매우, 극도로, 굉장히, 지나치게
treatment	치료, 대우, 처리, 관리
throat	목, 목구멍
patient	환자, 인내심, 참을성이 있는, 끈기 있는
speed	속도, 스피드, 빠름, 과속하다, 성공하다
growth	성장, 증가, 상승, 증대, 자람
quantity	양, 수량, 양적인, 다량
latin	라틴의, 라틴어
immense	굉장한, 막대한
conclusion	결론, 종료, 타결, 판단
computer	컴퓨터, 계산기
affected	영향을 받은, 감동한, 짐짓 꾸민
severe	심각한, 가차없는, 엄격한
excuse	변명, 핑계, 참아주다, 이유, 구실
triumph	승리, 이기다, 업적, 성공, 수상
origin	기원, 원산, 출신, 태생, 유래
joseph	요셉, 남자 이름, 승마용 여성 망토
slept	잤다, 잠을 이뤘다
eternal	영원한, 불멸의, 무한한, 불변의, 천추의
thine	그대의 것, 그대의, 너의 것
audience	관객, 청중, 관중, 시청자, 독자
swift	신속한, 빠른, 스위프트
limited	한정된, 제한을 받은, 특별 급행 열차
stepped	밟았다, 섰다, 계단이 있는
library	도서관, 서재, 장서
remaining	남은, 나머지의, 잔여의
base	기초, 기반, 위치하다, 기지, ~로 만든
confusion	혼란, 혼동, 논란, 현기증
win	우승하다, 승리하다, 따다, 이기다
maid	가정부, 처녀
charming	매력적인, 멋진
softly	부드럽게, 천천히, 조용히
reality	현실, 리얼리티, 실제, 사실
glorious	영광스러운, 화려한, 훌륭한, 즐거운
likewise	마찬가지로, 역시, 똑같이, 동감이야
site	사이트, 현장, 유적지, 장소, 부지
sail	항해, 배, 출항하다, 돛
frightened	깜짝 놀란, 두려움을 느끼는, 겁을 먹은, 무서워하는
acquainted	사귀게 된, 알고 있는, 지식이 있는
unhappy	불만스러운, 불행한, 불쾌한, 불운한
article	기사, 조항, 논문, 규약, 물건
store	가게, 상점, 매장, 저장, 점포
adopted	채택된, 입양된, 도입, 사용한, 규정
shalt	shall의 직설법·2인칭 단수·현재형
remark	발언, 말, 언급, 견해, 이야기
cook	요리사, 요리하다, 만들다, 쿡, 조리된
thousands	천의 자리
pause	멈춤, 휴식, 중단
inclined	경향이 있는, 마음이 내키는, ~하고 싶은, 기울어진
convinced	확신하는, 설득했다, ~라고 생각하다
band	밴드, 그룹, 대역, 악단, 무리
valuable	가치있는, 귀중한
hence	그러므로, 앞으로
desert	사막, 버리다, 탈영하다, 비우다, 황무지
effects	효과, 영향, 결과, 파장, 작용
kiss	키스, 입맞춤, 뽀뽀
plant	공장, 식물, 심다, 설비, 시설
ice	얼음, 아이스, 빙하, 빙상, 얼리다
ball	공, 볼, 무도회, 구기, 투구
stick	막대기, 고수하다, 붙다, 갇히다, 찌르다
absolute	절대적인, 완전한, 가장 ~한, 확실한, 정말
readily	쉽게, 기꺼이, 즉시, 선뜻, 쾌히
behold	~을 바라보다, 보다, ~을 주시하다
fierce	치열한, 거센, 격렬한, 사나운, 험악한
argument	주장, 논쟁, 말다툼, 논점, 논거
observe	관찰하다, 보다, 지키다, 준수하다, 목격하다
blessed	신성한, 축복 받은, 행복한
bosom	가슴, 품, 심복의
rage	분노, 대유행, 화를 내다, 격렬, 맹위
striking	파업 중인, 공격의, 두드러진, 놀랄만한, 타격의
discovery	발견, 디스커버리호, 발각
guilty	유죄의, 죄책감, 죄의, 범죄적인
related	관련된, 관계된, 연관된, 친척
setting	세우다, 환경, 배경, 무대, 세팅
forgot	잊었다, 두고 갔다, 까먹었다, forget의 과거·과거 분사형
punishment	처벌, 체벌, 벌, 징계, 처형
gun	총, 무기, 포, 거물
slightly	약간, 조금, 가볍게
police	경찰, 치안, 폴리스, 공안, 순경
mysterious	신비의, 불가사의한, 비밀의, 이상한, 미지의
extended	쭉 뻗은, 연장한, 장기간에 걸친
confess	고백하다, 자백하다, 시인하다, 인정하다, 실토하다
shade	그늘, 빗금친, 색조, 명암, 그림자
murder	살인, 살해, 죽이다
emotion	감정, 기분, 감동, 감성, 정서
destruction	파괴, 파멸, 멸망, 파기
increasing	증가하는, 점점 더 느는, 증대하는
hide	숨기다, 감추다, 은닉하다
expedition	탐험, 원정, 여행
horror	공포, 무서움, 호러, 참상
local	국내의, 지역의, 지방의, 현지의, 주민
ignorant	모르는, 무지한, 무식한, 무시하는
doctrine	원칙, 독트린
generous	관대한, 후한, 너그러운, 마음이 넓은, 아량이 있는
range	이르다, 범위, 사거리, 산맥, 사격장
host	개최하다, 주최하다, 진행자, 다수의, 호스트
wet	젖은, 습한, 축축한, 적시다
cloud	구름, 클라우드, 먼지, 흐림, 연기
mystery	미스터리, 수수께끼, 신비, 추리, 비밀
ed	남자 이름, 규칙 동사의 과거 형을 만듦, 명사에 붙어서 「~이 있는」 「~을 가진」의 뜻의 형용사를 만듦
waste	낭비하다, 쓰레기, 쇠약하다
possess	보유하다, 가지다, 소유하다, 홀리다, 소지하다
consciousness	의식, 인식, 정신
february	2월
trembling	떨림, 전율하는, 떨기
disease	질병, 병, 질환, 병폐, 부패
formerly	이전에, 옛날에는, 원래는
spend	보내다, 쓰다, 지출하다, 소비하다, 사용하다
production	생산, 제작, 제품, 프로덕션
source	정보원, 원천, 공급자, 출처, 소스
mankind	인류, 인간
universal	전 세계의, 보편적인, 공통의, 우주의, 만유인력
deck	층, 갑판, 카드 한 벌, 장식하다, 카세트
estate	재산, 소유권, 계급, 사유지
aunt	이모, 고모, 숙모, 아주머니
reign	통치하다, 군림하다, 지배하다, 재임하다, 집권하다
humble	겸손한, 초라한, 소박한, 겸허하게 하다, 사견으로
compliance	따르기, 준수, 추종
delay	지연시키다, 연기하다, 늦추다, 미루다, 지체시키다
shining	반짝이는, 빛나는, 밝은
hers	그녀의 것
unfortunate	불행한, 유감스러운, 불운한
midnight	자정, 한밤중
listening	듣기, 귀를 기울임, 경청, 청취
flower	꽃, 꽃을 피우다
hero	영웅, 주인공, 용사
accomplished	성취된, 완성된, 기성의
doth	do의 3인칭·단수·직설법·현재
philosophy	철학, 생각, 이념, 이론
belong	속하다, ~의 것이다, 소유하다, 어울리다
finger	손가락, 지적하다
comfortable	편안한, 편한, 안락한, 안정된, 마음 편한
market	시장, 마켓, 상가
cap	모자, 상한, 뚜껑, 캡, 마무리짓다
waves	해군 여자 예비 부대
troubled	괴로운, 어수선한, 곤란한
picked	집었다, 뽑혔다, 선정했다, 들다, 꼽았다
european	유럽의
somewhere	어딘가에, 어떤 곳, 대략, 언젠가
delighted	기쁜, 즐거워하는
pushed	추진, 밀렸다, 강요, 주장, 강행
press	기자, 언론, 보도, 누르다, 다급해지다
household	가구, 가정의, 가족의, 세대
fleet	함대, 동일 집단의, 비행대, 순식간의, 덧없는
baby	아기, 새끼, 어린이용의, 자기
region	지역, 지방, 지대
lately	최근에, 요즘, 요새, 근래
exact	정확한, 완전한, 강요하다, 정밀한, 딱 맞는
image	이미지, 사진, 모습, 영상, ~상
melancholy	우울한, 구슬픈, 감성적인
suspicion	의심, 혐의, 용의
bowed	숙인, 활처럼 휜, 활 모양의
refuse	거부하다, 거절하다, 쓰레기, 사절하다
elizabeth	여자 이름, 엘리자베스, Elisabeth
staff	직원, 참모, 스태프, 간부, 동료
liability	의무, 책임, 부채
we'll	we will, we shall의 단축형
gaze	시선, 보다, 응시하다
ashamed	부끄러워, 창피한, 수치스러운
reward	보상, 대가, 상, 상금, 보답
meal	식사, 한끼, 음식, 먹다, 가루
blame	비난하다, ~탓하다, 책임, 나무라다
status	지위, 상태, 신분, 현상, 사정
indicate	나타내다, 지적하다, 가리키다, 표시하다, 암시하다
poem	시
savage	야만적인, 잔인한, 야생의, 무자비한, 치열한
arise	발생하다, 생기다, 일어나다, 비롯되다, 나타나다
voyage	항해, 여행, 탐험
misery	고통, 비참, 불행, 어려움
painted	그린, 채색한, 과장된
attend	참석하다, 다니다, 주의하다, 돌보다
afford	여유가 있다, 할 수 있다
donate	기부하다, 기증하다
job	일, 직업, 일자리, 직무, 수술
proceed	진행하다, 수익, 추진하다, 계속하다, 시작하다
forehead	이마
regret	후회하다, 유감, 아쉬움
plainly	분명히, 명백히
risk	위험, 리스크, 위기, 우려, 모험하다
ad	서기 ~년, 광고
angel	천사, 에인절스, 엔젤, 착한 사람
rapid	빠른, 급속한, 급격한, 신속한, 가파른
distinct	뚜렷한, 독특한, 다른
doubtless	의심할 여지 없이, 틀림없이
properly	제대로, 적절히, 잘, 올바르게, 적당히
wit	재치, 지혜, 제정신, 지성
fame	명성, 명예, 유명, 인기, 이름
singular	단수의, 독특한, 특별한
error	실수, 오류, 잘못, 오차, 에러
utmost	최선, 최대한, 최고, 극도, 최우선
reputation	명성, 평판, 명예, 유명, 인기
appeal	호소, 항소, 매력, 마음에 들다, 항의
she's	she is, she has의 단축형
w	영어 알파벳의 스물셋째 자, watt, week, weight
strongly	강력히, 강하게, 적극적으로, 완강히, 단호히
margaret	여자 이름
lack	부족, ~이 없다, 결핍, 부재, 모자라다
breaking	파괴, 단모음의 이중 모음화
dawn	새벽, 동이 트다, 시작, 생각나다
violence	폭력, 충돌
fatal	치명적인, 죽음에 이르는, 불행한
render	되게 하다, 제공하다, 표현하다
career	경력, 직업, 활동, 직장, 커리어
design	디자인, 설계하다, 고안되다, 제작되다, 도안
displayed	날개와 다리를 편 모양의
commercial	상업용의, 상업적인, 광고, 민간의, 통상의
forgive	용서하다, 양해하다, 탕감하다, 실례지만
agreeable	동의할 만한, 마음에 드는, 쾌적한, 상냥한
suggestion	제안, 의견, 조언, 암시, 명제
utter	말하다, 심하게, 완전한, 매우, 전혀
sheep	양
resolution	결의, 결심, 해결, 해상도, 계획
spare	아끼다, 여가, 남은, 여유, 예비의
patience	인내, 참을성, 끈기
domestic	국내의, 내수, 가정의, 자국의, 국산의
'tis	it is의 단축형
farm	농장, 양식장, 경작하다, 농지, 사육하다
reference	참고, 언급, 추천서, 관련, 인용
chinese	중국인, 중국의, 중국어, 중국 사람
exist	존재하다, 있다, 살다, 나타나다
corn	옥수수
alike	똑같이, 모두, 비슷한, 한결같이
mounted	말을 탄, 마상 근무의, 기동력이 있는
jane	처녀, 여자, 여자 이름
issue	문제, 이슈, 사안, 발행하다, 쟁점
key	핵심, 주요한, 열쇠, 중요한, 키
providing	제공하는, 지원하는, 주는, 제시하다
majority	다수의, 대부분, 과반수, 여당의
flame	불꽃, 화염, 타오르다, 불태우다, 애인
boston	보스턴, 보스턴 왈츠
ignorance	무지, 모르는, 무식, 무시
reduced	축소한, 몰락한, 절감한
occasionally	때때로, 가끔, 종종, 이따금, 자주
y	영어 알파벳의 스물다섯째 자, 제2의 미지수
weakness	약점, 부진, 약함
furnished	가구가 갖추어진, 재고가 있는, 가구 딸린
china	중국, 도자기, 중화 인민 공화국
flying	나는, 비행하는, 항공, 비행기를 조종하는, 운항
cloth	천, 옷감, 직물, 걸레, 식탁보
profit	이익, 수익, 이윤, 순익, 수입
fourth	4번째, 4분의 1, 4일
bell	종, 벨, 신호
hitherto	지금까지, 여기까지, 지금까지는
benefit	이익, 혜택, 도움이 되다
eagerly	간절히, 고대하여, 열성적으로, 적극
ascii	미국 정보 교환 표준 부호, 아스키
disposed	경향이 있는, 마음이 나는, ~한 성질의
electronically	전자 적으로, 전자식으로
atmosphere	분위기, 대기, 기압
chapter	장, 챕터, 편
helen	여자 이름, 헬레네, 헬렌
hole	구멍, 홀, 구덩이, 허점, 동굴
borne	편협한, 「~으로 운반된」의 뜻, 시야가 좁은
departed	죽은, 지나간, 과거의
catholic	가톨릭 교회의, 천주교의, 가톨릭교도
reasonable	합리적인, 합당한, 이성적인, 분별이 있는, 논리적인
sugar	설탕, 당분, 사탕수수, 겉치레말
replacement	교체, 대체, 대신하는 사람, 다른
sigh	한숨, 안도의 숨을 쉬다, 탄식
humanity	인류, 인간성, 인간애
thrust	내밀다, 추진하다, 생겨나다, 떠넘기다, 제쳐놓다
frame	틀, 프레임, 액자, 구조, 테두리
opposition	야당, 반대
disk	디스크, 접시, 원반, 음반
haste	서두르다, 성급함
lonely	외로운, 혼자, 쓸쓸한, 고독한
artist	예술가, 화가, 아티스트, 가수, 미술가
knight	기사, 나이트, 훈작위, 보호자
charm	매력, 매혹하다, 부적, 주문, 애교
substance	물질, 본질
flung	fling의 과거·과거 분사형
celebrated	유명한, 저명한, 이름난
division	~부, 분열, 부문, 사단, 분단
slavery	노예제, 노예 제도
verse	절, 정통하다, 시
decision	결정, 판결, 선택, 결단, 결심
probable	가능성, 그럴듯한, 확실한
painful	고통스러운, 아픈, 힘드는, 괴로운
governor	지사, 총재, 장관, 군주
forever	영원히, 항상, 계속, 완전히, 장시간
branch	지점, 가지, 지사, 지부, 지국
ocean	바다, 해양, 대양
rear	뒤의, 양육하다, 세우다
leader	지도자, 대표, 정상, 리더, 선도자
delightful	즐거운, 기쁜, 마음에 드는, 반가운, 달콤한
keen	예민한, 예리한, 날카로운, 관심이 많은, 열중한
disposition	기질, 처분, 성향, 생각
readable	읽을 수 있는, 판독하기 쉬운, 읽기 쉬운
beloved	가장 사랑하는, 소중한, 애인
enthusiasm	열정, 열광, 열망
luck	행운, 운, 재수, 행복
derived	파생된, 유래된
community	사회, 공동체, 커뮤니티, 단체, 집단
apparent	분명한, 명백한, 뚜렷한, 확실, 겉으로는
preserved	취한
magnificent	웅장한, 훌륭한
hurry	서두르다, 빨리 ~하다, 급하다, 바쁘다, 재촉하다
scheme	계획, 음모, 조직, 설계
oil	석유, 기름, 오일, 원유, 유화
thence	그 때부터, 거기서부터, 그것이 원인으로
dim	어두운, 조명을 줄이다, 불투명한, 우둔한
wretched	비참한, 비열한
hanging	교수형, 매달기, 걸린
pipe	파이프, 관, 담뱃대
useless	쓸모없는
nevertheless	그럼에도 불구하고, 그렇지만, 어쨌거나
print	인쇄하다, 인쇄물, 프린트, 출판물, 지문
smooth	원활한, 부드러운, 매끄러운, 매만지다
solid	단단한, 확실한, 고체의, 연속된, 훌륭한
necessarily	반드시 ~은 아닌, 필연적으로
build	건축하다, 짓다, 만들다, 세우다, 기르다
attempted	미수의, 시도한, 기도한
equivalent	해당하는, 맞먹는, 동등한, 상당하는, 등가의
hastily	성급하게, 서둘러서
you'd	you had 또는 you would의 단축형
recent	최근, 최신
oh	오, 그렇군, 잠깐, 어머나
travel	여행, 이동, 운행, 달리다, 교통
noon	정오
crying	울부짖는, 눈물을 흘리는, 긴급한
located	~에 위치한
cabin	객실, 오두막
announcement	발표, 말하다, 안내방송, 성명, 공지
britain	영국
handed	손잡이가 있는, 손이 있는, ~명이 하는
cease	중단하다, ~가 아닌지 오래된, 사라지다
smaller	더 작은, small의 비교급
circumstance	상황, 환경, 사정, 정황
tent	텐트
frequent	자주, 잦은, 빈번한, 종종, 흔한
alarm	알람, 경보, 경종, 자명종, 깜짝놀라게 하다
nervous	긴장되는, 불안한, 신경의, 초조한, 걱정하는
beast	비스트, 짐승, 야수, 동물, 괴물같은
what's	what is,what has의 단축형, what does의 단축형
aloud	소리내어, 큰 소리로
independent	독립한, 무소속의, 독자적인, 인디, 자유의
gates	게이츠, 문, 입구
distinction	구별, 차이, 차별, 영예
essential	필수의, 필요한, 가장 중요한, 없어서는 안 될, 기본적인
observation	관찰, 관측, 전망, 의견
recovered	회복한
belonging	소유물, 소지품, 속성
loving	사랑하는, ~을 좋아하는, 애정 어린
masters	마스터스 골프, 석사
permanent	영구적인, 정규직의, 상설의, 영원한, 파마
mortal	인간의, 죽음의, 현세의, 치명적인
stern	엄중한, 엄격한, 강경한, 단호한, 준엄한
gratitude	감사, 고마움, 사의
preserve	보존하다, 보호하다, 지키다, 유지하다, 보전하다
burden	부담, 부담감, 짐, 책임
aspect	측면, ~면, 양상, 모습, 관점
merry	즐거운
knife	칼, 나이프, 부엌칼, 흉기, 식칼
dread	두려워하다, 불안, 큰 공포
clever	영리한, 똑똑한, 재치 있는, 독창적인, 현명한
applicable	적용할 수 있는, 적절한, 적용 가능한
district	지역, 지방, 행정구, 지구, 선거구
jim	남자 이름, 못쓰게 만들다
silk	실크, 비단
failure	실패, 실수, 실패작, 하지 않기, 부재
links	골프코스(golf course), 모래땅
cent	센트, 돈
sentiment	심리, 정서, 감정
amid	가운데, 속에서, 중에, 상황, 한창
agent	요원, 첩보원, 에이전트, 직원, 대리인
bade	bid의 과거형
desperate	필사적인, 절망적인, 절실한, 자포자기의, 극도의
union	노동조합, 단체, 연합, 연방, 아메리카 합중국
contempt	경멸, 모욕, 무시
raising	키우는, 인상, 높이는, 모금, 오르는
hell	지옥, 도대체, 만에 하나, 악화되다
separated	별거 중에, 따로 떨어져 생활하여
grant	부여하다, 주다, 보조금, 허가하다, 승인하다
seriously	심각하게, 진지하게, 크게, 정말, 심하게
hit	치다, 히트를 치다, 타격, 달하다, 명중하다
enormous	거대한, 막대한, 엄청난
defective	결함있는, 불량품, 불완전한
conviction	확신, 유죄 판결, 설득력, 자각
mixed	혼성의, 혼합한, 뒤섞인
wooden	나무의, 목제의, 나무로 만든
prefer	선호하다, 좋아하다
fever	열, 고열, 열풍, 열병, 흥분
selected	선택된, 선발된, 정선된
treat	치료하다, 대하다, 대우하다, 취급하다, 대접하다
warning	경고, 경보, 주의, 조짐, 사전 통보
flew	fly의 과거형, 어망
developed	개발한, 선진의, 키운, 발생한, 현상된
impulse	충동, 자극, 원동력, 욕망
ours	우리의, 우리의 것, 우리 회사
mistaken	잘못된, 오해한, 실수
damages	손해배상
ambition	야심, 야망, 꿈, 욕심
christmas	크리스마스, 성탄절
yield	굴복하다, 수익률, 수익, 양보하다, 내다
ideal	이상적인, 이념적인, 관념적인
confirmed	확인된, 승인된, 굳어진
descended	물려받은, 내려온, 전해진
rush	서두르다, 급한, 돌진하다, 재촉하다, 혼잡
deny	부인하다, 부정하다, 거부, 아니다, 못하다
calculated	면밀히 계산된, 고의적인, 산정된
correct	정확한, 수정하다, 맞다, 올바른, 옳은
perform	공연하다, 수행하다, 연주하다, 연기하다, 노래하다
hadn't	had not의 단축형
somehow	어떻게든지 하여, 어쩐지, 어쨌든, 다소, 그럭저럭
accordingly	그에 따라, 따라서, 적절히
acquired	습득한, 후천적인, 학습된
counsel	특별 검사, 변호사, 상담, 조언
distress	고통, 고난, 곤란, 걱정, 지친
sins	Ship's Inertial Navigation System(선박 관성 항행 장치)
notion	개념, 생각
discussion	논의, 토론, 심의
constitution	헌법, 규약, 체격
anne	여자 이름, 앤
hundreds	백의 자리
instrument	악기, 도구, 기구
firmly	확고하게, 강하게, 꽉, 자신 있게
steady	지속적인, 안정된, 견실한, 고정된
remarks	발언, 말, 견해, 언급, 발표
empire	제국, 왕국
idle	게으른, 빈둥거리는, 나태한, 헛되이 보내다
pen	펜, 작가, 만년필, 문필
online	온라인의, 접속되어
africa	아프리카
permit	허용하다, 허가하다, 허락하다, 용납하다
tide	조수, 극복하다, 흐름
college	대학, 연구소, 칼리지
maintain	유지하다, 주장하다, 계속하다, 지속하다, 관리하다
sovereign	소버린, 주권의, 독립의, 최고의, 국왕
tail	꼬리, 끝
generation	세대, 시대
crowded	붐비는, 혼잡한, 가득 찬, 만원의, 가득 차서
nights	밤마다, 밤에는 언제나, 밤에
limitation	한계, 제한, 제약, 한정, 제한하는 것
horrible	끔찍한, 무서운, 지독한, 소름 끼치는, 참담한
cat	고양이, 고양이과 동물
port	항구, 항만, ~항, 포트
male	남성, 수컷, 말레
experienced	경험있는, 겪었다, 받았다, 노련한, 숙련된
opposed	대항하는, 반대의, 적대적인
treaty	조약, 협정, 협약
contents	내용물, 컨텐츠
rested	원기를 회복한
mode	모드, 형태, 방법, 상태, 최빈수
les	launch escape system(비상 탈출 장치), 레스비언, 여성 동성애
occur	발생하다, 일어나다, 생기다, 나타나다, 발견되다
seeking	「~을 찾는」의 뜻
practically	사실상, 실제로, 실질적으로, 실용적으로
abandoned	버림받은, 제멋대로의, 파렴치한
eleven	열하나
sank	침몰한, 가라앉은, 감소한, 해가 지는, 쓰러진
founded	설립된, 세워진, 창업, 만든, 건설
trace	추적하다, 흔적, 발견하다, 유래하다, 귀결되다
instinct	본능, 직감, 직관
collected	침착한, 모은, 수집한
scotland	스코틀랜드
characteristic	특성, 독특한, 특징적인
chose	선택했다, 선정했다, 채택했다
cheerful	쾌활한, 좋아 보이는
tribe	부족, 집단
threatened	위협당한, 협박당한, 위기, 경고, 우려
arrangement	준비, 배열, 계획, 계약, 합의
western	서양의, 서부의, 서쪽의
sang	노래했다
sam	남자 이름, 샘, 지대공 미사일
pressure	압력, 압박, 부담, 스트레스, 기압
politics	정치, 정계
shelter	보호, 대피소, 피난처, 은신처, 수용소
rude	무례한, 거친
scientific	과학적인, 정밀한
riding	구, 승마, 승마의
shake	흔들다, 떨쳐버리다, 악수하다, 떨다, 잡다
industry	산업, 업계, 제조업, 공업
merit	장점, 이점, 가치, 공로, 혜택
profession	직업, 직종, 직위
lamp	램프, 전등, 스탠드, 빛
interview	인터뷰, 면접, 면담, 회견
territory	영토, 지역, 영역, 세력권
sleeping	자는, 잠, 수면, 숙면
sex	성, -性-, 섹스, 성교, 자다
coffee	커피
devotion	헌신, 정성
thereof	그것에 관하여, 그것으로, 그것의
creation	창출, 제작, 창조, 창설, 탄생
trail	오솔길, 질질 끌다, ~을 추적하다
romans	로마서, (약어)Rom
prospect	전망, 가능성, 가망성, 장래성
obey	복종하다, 따르다, 준수하다, 응하다
alexander	남자 이름, 알렉산더
shone	빛났다, 비치고 있었다
operation	운영, 작전, 수술, 사업, 활동
northern	북부의, 북쪽의, 북의
nurse	간호사, 보건실, 수유하다
profound	심오한, 깊은, 지대한
hungry	배고픈, 부족한, 먹고 싶은, 기아의
scott	스콧, 남자 이름
assure	확신시키다, 보장하다, 확인하다, 분명히 ~이다
exceedingly	대단히, 몹시, 과하게
match	경기, 어울리다, 성냥, 짝, 필적하다
wrath	분노, 격노, 복수
continually	계속해서, 지속적으로, 끊임없이, 자꾸
folly	어리석음, 바보짓
chain	체인점, 체인, 사슬, 연쇄
uniform	유니폼, 똑같은, 일제히
debt	부채, 빚, 채무, 부족
teaching	가르치기, 교수, 수업
venture	모험, 투기적 사업, 모험적 사업
execution	사형 집행, 처형, 실행, 솜씨
shoes	신발, shoe
mood	기분, 분위기, 무드, 감정, 마음
crew	승무원, 선원, 패거리
perceive	인식하다, 인지하다, ~로 생각하다, 인상을 주다
eating	먹는, 식사를 하는, 소비하는, 맛보다, 잠식하는
multitude	다수, 많은
declare	선언하다, 말하다, 선고하다, 주장, 신고하다
yard	마당, 야드, 운동장
o'er	over
astonishment	놀라운 일, 놀람
version	버전
vague	모호한, 애매한, 희미한
odd	이상한, 특이한, 홀수의, 별난
grateful	감사하는, 고마운
nearest	가장 가까운, 제일 가까운
infinite	무한한
elsewhere	다른 곳, 어떤 딴 곳에, 어느 곳이나
copying	복사, 등사
apartment	아파트
activity	활동, 행위, 행사, 기능, 활기
wives	아내, 주부
parted	조각난, 깨진, 갈라진
security	안보, 보안, 안전, 보장, 증권
sensible	현명한, 합리적인
owing	~때문에, ~해서, ~덕택에, 빚지고 있는
martin	남자 이름, Saint Martin of Tours, 성 마르티누스, 몇 종의 제비의 총칭
saturday	토요일
cottage	오두막, 별장, 집의, 보금자리
leaning	기울기, 경사, 경향
capacity	능력, 용량, 가능성, 자격, 기능
joe	녀석, 병사, 남자 이름
settle	해결하다, 정착하다, 타협을 보다, 진정시키다, 결정하다
francis	남자 이름, 프랜시스, 프란치스코
holder	보유자, 소유자, 가지고 있는 사람, 홀더
involved	관련된, 관여하는, 연루된, 참가한, ~을 포함하는
sunshine	햇빛, 맑은 날씨, 성격이 밝다
dutch	네덜란드의, 네덜란드인, 네덜란드어, 독일의
council	위원회, 회의, 의회, 협의회, 평의회
ate	먹었다
examination	시험, 검사, 조사, 검토, 진찰
steel	철강, 강철, 스틸, 제강
beheld	behold의 과거·과거 분사형
test	시험, 실험, 테스트, 검사, 조사하다
noted	유명한, 저명한, 현저한
widow	미망인, 홀아비
charity	자선, 자애, 구호, 적선
element	요소, 원소, 구성, 부분, 원리
shed	흘리다, 벗다, 빠지다, 창고, 탈피하다
communication	통신, 소통, 대화, 커뮤니케이션, 교신
reflection	반영, 반성, 반사, 심사숙고
organization	단체, 기구, 조직, 기관, 협회
maintained	재정 지원을 받는
accordance	~에 따라, 일치
star	스타, 별, 주연, 인기 배우, 항성
somebody	누군가, ~한 사람, 대단한 사람
incident	사건, 사고, 사태, 사변
oath	선서, 맹세
guest	손님, 하객, 게스트, 고객, 투숙객
bar	바, 술집, 막대, 판매대
row	논란, 줄, 노젓기
poverty	빈곤, 가난
bottle	병, 우유, 병에 담다, 술, 술병
bless	축복하다, 감사하다, 지지하다
stir	일으키다, 젓다, 동요시키다, 섞다, 혼란
intense	강렬한, 집중적인, 심한, 거센
completed	작성한, 작성된
quarrel	싸우다, 다투다, 언쟁하다
touching	~에 관하여, 감동적인, 남의 마음을 움직이는
inner	내면의, 내부의, 내적인, 속의, 안쪽의
available	이용할 수 있는, 가능한, 유용한, 시간이 있는, 유효한
fix	고치다, 해결하다, 고정하다, 음식을 준비하다, 정하다
resistance	저항, 반대, 내성, 저지, 레지스탕스
unusual	특이한, 드문, 독특한, 이상한, 특별한
deed	행위, 행동, 공적, 증서
derive	기인하다, 얻다, 나오다
hollow	공허한, 우묵해지다, 도려내다
suspected	의심이 가는, 의심을 받고 있는
province	지방, 성, 주
deserted	버려진, 탈주한, 사람이 살지 않는, 인기척이 없는, 황폐한
establishment	설립, 시설, 설치, 체제, 수립
vote	투표, 표, 선거, 표결
thither	저쪽의, 그쪽으로, 거기에
oxford	옥스퍼드 천, 옥스퍼드 슈즈, 영국 런던 서북쪽의 도시
cavalry	기병대, 기병, 승마자
lofty	높은, 숭고한, 원대한
endure	견디다, 지속하다, 겪다, 이기다, 허락하다
succeed	성공하다, 뒤를 잇다, 후임이 되다, 계속되다, 계승하다
leg	다리, 발, 경기, 의족
bid	입찰, 유치, 시도, 작별을 고하다, 출마
alice	여자 이름, 앨리스
civilization	문명
acting	연기, 움직이는, 대리의, 연극, ~처럼 굴다
landed	토지의, 토지를 가진, 토지로 이루어진
interior	내부, 인테리어, 실내, 내륙부, 내장
scarce	부족한, 희귀한, 드물게, 적은
lightly	가볍게, 살짝, 쉽게, 들떠서, 경솔히
disturbed	불안한, 산란한, 마음이 동요하고 있는
supreme	최고의, 궁극의, 절정
hang	걸다, 달다, 교수형에 처하다, 견디다, 서성거리다
notwithstanding	~에도 불구하고, 할지라도
shock	충격, 놀라게 하다, 쇼크, 타격, 감전되다
exception	예외, 이의, 제외, 반대
offering	제공하는, 주는, 내놓는, 제안하는, 강좌를 개설하는
display	(작품을) 전시하다, 보여주다, 디스플레이, 표현하다, 진열하다
strain	긴장, 부담, 계통, 변종, 경직되다
drank	마셨다
confined	한정된, 감금되는, 제한된
o	영어 알파벳의 열다섯째 자
exhausted	다 써버린, 소모된, 기진맥진한
aim	목표, 목적, 겨냥하다, 노리다, 조준하다
critical	중요한, 비판적인, 중대한, 결정적인, 위험한
jerusalem	예루살렘, 유대교·크리스트교·이슬람교의 성지, 고대 팔레스타인의 수도
negro	흑인
fearful	두려워하는, 무서운, 우려되는
standard	기준, 표준, 수준, 윤리, 규격
studied	공부했다, 연구했다, 전공했다, 신중히 고려하다
bag	가방, 봉지, 백, 주머니, 봉투
n	영어 알파벳의 열넷째 자, 명사, north, number
buildings	건물
repeat	따라하다, 반복하다, 다시 말하다, 되풀이되다
driving	운전, 차로 가다, 내몰다, 질주하는, 이끄는
track	추적하다, 트랙, 궤도, 육상 경기
rid	없애다, 제거하다, 버리다, 지우다, 폐지하다
residence	주택, 저택, 거주지, 주거, 댁
steadily	꾸준히, 지속적으로, 점차, 서서히, 끊임없이
intimate	친한, 친구, 개인적인, 암시하다, 성적인
drinking	마시기 알맞은, 음주의, 음주
swear	욕하다, 맹세하다, 단언하다
treasure	보물, 소중히 하다, 부
fun	재미있는, 즐거운, 놀리다, 신나는, 장난
throwing	던짐, 투척
apt	~하기 쉬운, ~하는 경향이 있는, 적절한
enterprise	기업, 사업
queer	괴상한, 동성애의
seed	씨앗, 뿌리다, 시드
tower	탑, 타워, 고층 빌딩, 뛰어나다
defend	지키다, 방어하다, 옹호하다, 변호하다, 보호하다
favourite	좋아하는, 마음에 드는, 인기 있는, 우승 후보
heavily	크게, 상당히, 과하게, 두껍게, 엄격하게
assembled	모인, 집합된, 결집한
stuff	물건, 넣다, 음식물, 물질
section	부분, 섹션, 부문, 구역, 부서
settlement	정착, 해결, 합의, 타결, 식민지
staring	아주, 빤히 쳐다보는, 전혀
sole	유일한, 밑창, 홀로, 단독의, 독점적인
plate	접시, 판, 음식, 번호판, 플레이트
mexico	멕시코
overcome	~을 극복하다, ~에 이기다, ~을 압도하다
performing	실행하는, 성취하는, 공연하는
dwell	생각하다, 살다, 설명하다, 머무르다
taxes	taxis의 복수형, tax의 복수형
marble	대리석, 구슬, 마블
recently	최근에, 요즘에, 얼마전, 근래에, 요즈음
ability	능력, 재능, 역량, 수완, 솜씨
awake	깨다, 잠에서 깨다, 깨어나다
walter	남자 이름, Bruno, 발터, John Walter 월터 1세
wave	파도, 흔들다, 파, 유행, 변화
shaking	흔들기, 한 번 흔들기, 떨림
folk	민속의, 사람들, 민속 음악의, 포크, 민요의
possibility	가능성, 기회
butter	버터, 아부를 하다
fury	분노, 격분, 격렬
moses	모세, 이스라엘인을 이끌고 이집트를 탈출한 히브리 지도자
hatred	증오, 혐오, 싫어함, 미움
pursuit	추구, 추격, 쫓음
pull	당기다, 끌다, 철수시키다, 뽑다, 빼다
furniture	가구
hid	숨겼다,  Headquarters Intelligence Department(육군 첩보 부대), high intensity discharge
rope	줄, 요령, 묶다
adventure	모험, 어드벤처, 도전
royalty	로열티, 왕정
elder	어른, 노인, 연장자, 장로, 고참
signal	신호, 시작을 알리다, 통신, 나타내다, 조짐
wanting	모자라는, ~이 없는, 부족한
feast	축제, 진수성찬, 즐기다, 먹다
safely	안전하게, 무사히, 조심해서, 무방, 순조롭게
burn	타다, 화상, 연소하다, 소비하다, 굽다
describe	묘사하다, 설명하다, 표현하다, 기술하다, 그리다
lesson	수업, 교훈, 가르치다, 단원
annual	연간의, 연례의, 매년의, 연마다의, 해마다
card	카드, ~표(票), 명함, 카드놀이, 엽서
application	지원, 애플리케이션, 신청, 적용
intelligent	지적인, 지능이 있는, 똑똑한, 총명한
county	주, 군
beaten	맞은, 이긴, 잘 알려지지 않은, 혼난, 휘저은
presents	본문
format	판형, 포맷, 형태
flow	흐르다, 흐름, 유입, 유동, 나오다
sixty	60
scale	규모, 등급, 비늘, 척도, 저울
damage	피해, 손상, 손해, 배상금, 해치다
marks	마크스
moreover	게다가, 더욱이, 또한, 나아가
commerce	무역, 상업, 커머스
startled	~에 놀란
southern	남부의, 남쪽의
consequently	결과적으로, 그 결과로서, 그에 따른
outer	바깥의, 외부의, 외적인, 밖의
ben	안방, 산꼭대기, 남자 이름
wrought	만들어진
average	평균, 보통의
naked	벌거벗은, 나체의, 적나라한, 무방비로
rivers	리버스
obvious	분명한, 명백한, 뻔한, 확실한
foundation	재단, 기반, 창립, 토대, 파운데이션
concern	우려, 걱정, 관심사, 관심, 염려
ceremony	의식, 식, 의례
magic	마법, 마술, 매직, 요술, 매력
campaign	선거 운동, 캠페인, 운동, 광고, 조직적 활동
hunting	사냥, 수렵, 수색
carolina	캐롤라이나, 미국 North Carolina 주와 South Carolina 주
liberal	진보적인, 자유로운, 자유주의의, 개방적인, 관대한
whisper	속삭이다, 속삭임, 휘파람 불다
largely	주로, 대량으로, 다량으로
commonly	흔히, 일반적으로, 보통, 주로
torn	tear의 과거 분사형
hunt	사냥하다, 찾다, 수렵하다, 포획하다
teacher	교사, 선생, 교원, 스승
christianity	기독교
lawyer	변호사, 법률가, 변호인, 법조인
detail	세부, 구체적 내용, 상세, 자세한 정보, 사소한 것
shortly	곧, 금방, 얼마 안 있어, 간단히
caesar	시저, 카이사르, 로마 황제
wondering	기이한 듯한, 불가사의하게 여기는, 놀란
blessing	축복, 승인, 전화위복의
princess	공주, 왕세자비, 프린세스
he'd	he had, he would의 단축형
altar	제단, 분향소, 변기
tenderness	유연함, 민감함, 함부로 다룰 수 없음
tiny	작은, 조금, 유아의
web	웹, 인터넷, 거미줄
cardinal	추기경, 카디널스, 기본적인
sharply	급격하게, 날카롭게, 빈틈없이, 격렬하게
regiment	연대
chest	가슴, 생각, 서랍장, 상자, 흉부
distinctly	분명히, 뚜렷하게
purple	보라색, 자주색, 퍼플
gather	모이다, 수집하다, 모여들다, 모임, 받다
depth	깊이, 깊음
indignation	분노, 분개
performance	공연, 실적, 성과, 연기, 성적
election	선거, 투표, 당선, 선정, 선택
prosperity	번영, 번창
gloomy	우울한, 비관적인, 어두운
conception	개념, 임신, 계획
clerk	점원, 직원, 판매원, 사무원, 서기
decide	결정하다, 하기로 하다, 판결하다, 해결하다, 다짐
drunk	취한, 음주, 취중의
victim	희생자, 피해자, 이재민, 희생양
reflected	bent or sent back
pour	붓다, 따르다, 퍼붓다, 뿌리다
preceding	선행하는, 앞서는, 앞의
absurd	말도 안되는, 터무니없는, 황당한
lift	들어 올리다, 해제하다, 태워주다, 엘리베이터, 중량 운동
gesture	제스처, 몸짓, 몸동작
manage	관리하다, 운영하다, 어떻게든 ~하다, 다루다, 잘 해내다
brethren	같은 신자, 회원, brother의 복수형
hugh	남자 이름
motive	동기, 의도, 목적
whatsoever	whatever의 강조형
pointing	뾰족하게 만들기, 지시, 구두법
pronounced	뚜렷한, 명백한, 단호한
exchange	교환, 거래소, 환율, 바꾸다, 주고 받다
definite	분명한, 확실한, 명확한, 확정된, 명백한
emperor	황제, 천황, 왕
tendency	경향, 추세
remote	리모컨, 먼, 외딴, 원격의, 희박한
finish	끝나다, 마치다, 끝, ~로 끝내다, 처리하다
flag	국기, 깃발, 국적, 플래그
boots	구두닦이, 장화
enabled	「~구동의」 뜻
administration	정부, 행정, 정권, 관리, 경영
rarely	드물게, 거의 ~하지 않는, 좀처럼 ~하지 않는, 조금도
earnestly	진지하게, 진정으로
considering	고려하면, 감안, 검토, 생각, 계획
previously	이전에, 과거에, 기존에, 앞서, 지금까지
ugly	추한, 불쾌한
signed	계약했다, 서명했다, 체결했다, 합의한, 싸인했다
genuine	진실된, 진짜의, 순수한, 성실한
harmless	무해한, 순진한, 악의 없는
obedience	복종, 순종, 공손함
training	훈련, 교육, 트레이닝
badly	심하게, 나쁘게, 절실하게, 잘못, 매우
feed	먹이, 공급하다, 사료, 사육, 영상
central	중앙의, 중앙의, 중심의, 본부, 중추 신경의
contrast	대조, 대비, 차이, 대립, 대치
relieved	안심한, 안도한, 안도하는
romance	로맨스, 연애, 로망스어의
mississippi	미시시피, 미국 남부의 주, 미시시피 강
structure	구조, 건물, 구성하다, 조직
payment	지불, 지급, 돈, 대금, 상환
pace	속도, 페이스, 보조를 맞추다
succession	승계, 계속, 이양, 잇달아, 상속
inquiry	조사, 문의, 수사
inspired	영감을 받은, 영감을 받은 결과의, 직관적이지만 적확한
roll	말아올리다, 구르다, 굴리다, 말다, 롤
wilt	시들다, 시들게 하다, 무기력
inch	인치, 조금
perfection	완벽, 완성
wherever	어디든, 가는 곳마다, 어떤 경우에도
owe	빚지다, 신세지다, 가지다, 힘입다, 의무가 있다
handle	처리하다, 다루다, 감당하다, 손잡이, 만지다
trip	여행, 방문하다, 출장, 이동, 걸려 넘어지다
shoot	쏘다, 촬영하다, 사격하다, 발사하다, 슛
fortunate	다행인, 운 좋은, 행운의, 행복한
newspaper	신문
employment	고용, 취업, 업무, 일자리, 직업
fitted	장비가 갖추어진, 꼭 맞는, 알맞은
refuge	피난, 도피, 위안
misfortune	불행, 역경
providence	섭리, 신의 뜻, 신
cutting	오려낸 것, 절단, 재단
beard	턱수염, 대리
tear	눈물, 찢다, 파괴하다, 분열하다
resist	저항하다, 참다, 반대하다, 저지하다
maiden	처녀, 미혼의, 처음, 소녀
determine	결정하다, 결심하다, 결의하다, 단호하다, 측정하다
commission	위원회, 수수료, 의뢰, 권한, 사관
merchant	상인, 상선의, 무역상, 상업의
whereas	~임에 비하여, ~인데도, 서문
crossing	횡단하는, 넘다, 통과하다, 엇갈리는, 교류하는
independence	독립, 자립, 자주
lively	생생하게, 활발하게, 활기차게, 밝은
breeze	산들바람, 쉬운 일, 경쾌하게 드나들다
relative	친척, 인척, 상대적인, 비교적인, 비례한
solitary	혼자의, 독방 감금, 군거하지 않는
smell	냄새, 냄새를 맡다, 후각, 향기, 기미
wandering	헤매는, 종잡을 수 없는, 방랑
thereby	그것에 의하여
eighteen	열여덟
provision	조항, 규정, 대비, 지원
eaten	먹은, 식사한
historical	역사의, 전통적인
regarding	~에 대해, ~와 관련하여, ~에 관하여
preferred	선취권이 있는, 우선의, 발탁된
pick	고르다, 선택하다, 따다, 선발하다, 줍다
ruined	멸망한, 파멸된, 파멸한
wherein	어디에, 그 점에서, 거기서
vanity	허영심, 화장대
condemned	비난받은, 유죄를 선고받은, 사형 선고를 받은
deliver	전달하다, 배달하다, 전하다, 인도하다, 구해내다
unexpected	예기치 않은
desk	책상, 데스크, 안내소, 창구, 자리
gross	총, 전체, 역겹다, 더럽다, 징그럽다
lane	차선, 차로, 통로
represent	대표하다, 나타내다, 보여주다, 상징하다, 대변하다
root	뿌리, 원인, 찾아주다, 응원하다, 근절하다
mud	진흙, 진창
respectable	존경할 만한, 훌륭한, 고상한
testimony	증언, 증거, 입증
existing	현존하는, 현재의, 목하의
bride	신부
rang	ring의 과거형
responsibility	책임, 의무, 부담, 책무, 담당
beating	때리기, 패배, 고동
disappointed	실망한, 낙담한, 기대에 어긋난
suitable	적합한, 적당한, 적절한, 알맞은
depend	따라, 달리다, 의존하다, 의지하다, 좌우되다
judges	사사기
giant	거대한, 자이언트, 거인, 위대한
grasp	파악하다, 이해하다, 잡다, 손아귀
arrive	도착하다, 오다, 일어나다, 성공하다
simplicity	단순, 간단, 꾸밈없음, 평이함, 소박
autumn	가을
absent	결석한, 없는, 불참한, 결여된
legally	법적으로, 합법적으로
veil	베일, 숨기다, 면사포
gloom	침울해하다, 어두워지다
doubtful	의심스러운, 회의적인, 미심쩍은
suspect	의심하다, 용의자, 혐의를 받은, 생각하다, 피의자
determination	결심, 결정, 편향
feeble	약한, 부진한, 미약한
prophet	예언자, 선지자
shak	셰익스피어(Shakespeare)
gathering	모임, 모으기, 회의, 행사, 더하는
basis	근거, 기준, 기초, 토대, 기본
examine	조사하다, 검사하다, 시험하다, 심문하다, 친절하다
corrupt	부패한, 부정한, 타락한, 손상된
laying	애벌칠, 한 배에서 까는 알, 쌓기
prize	상, 상금, 상품, 경품
d	영어 알파벳의 넷째 자
they're	they are의 단축형
theatre	공연장, 극장
purchase	구입하다, 구매하다, 매수하다, 사다, 인수하다
comparison	비교, ~에 비해, 대조적으로
composition	구성, 작곡, 작문, 작품, 구도
rival	경쟁하는, 라이벌, 경쟁자, 적수, 대항하는
someone	누군가, 어떤 사람
realize	깨닫다, 알다, 실현하다, 인식하다, 달성하다
defeat	패배시키다, 이기다, 물리치다, 무찌르다
foe	적, 상대
shared	공유의
balance	균형, 잔고, 안정, 조화
intercourse	육체적 관계, 통상
slender	호리호리한, 날씬한, 가는
coach	감독, 코치, 지도하다, 보통석, 마차
criminal	범죄의, 형사상의, 범인
silly	어리석은, 바보, 어처구니 없는
humour	유머, 해학
indifferent	무관심한, 중요치 않은, 개의치 않는
recall	상기하다, 리콜, 기억하다, 소환하다, 회수하다
occupation	직업, 점령, 일제 식민통치
discourse	담론, 강연, 말하다
assist	돕다, 지원하다, 어시스트, 보조, 조력하다
novel	소설, 기발한, 참신한
intellect	지성, 지식인
leads	예비 고객 명단
hither	여기로, 이쪽 편의, 이쪽으로
tales	보결 배심원, 보결 배심원 소집 영장
sale	판매, 매각, 세일, 매매, 매출
revenge	복수, 보복
yonder	저곳에, 저쪽에, 저쪽의
jealous	질투하는, 시기하는, 부러워하는, 탐내는
we're	we are의 단축형
wheel	바퀴, 자동차의 핸들, 자동차, 관람차
invitation	초대, 초청
narrative	이야기, 설명적인, 담화, 대사, 화자
risen	오른, 증가한, 상승한, 늘어난, 일어난
burnt	불에 탄, 소각된, 화상을 입은, 피로한, 각인하는
inferior	열등한, 질이 떨어지는, 열악한
amusement	즐거움, 오락, 재미, 놀이
flash	플래시, 번쩍이다, 불빛, 섬광, 떠오르다
recognize	인정하다, 인식하다, 알아보다, 알다, 깨닫다
swiftly	신속히, 빨리, 급격하게, 즉시, 순식간에
portrait	초상화
create	만들다, 만들어 내다, 창조하다, 제작하다, 생산하다
suggest	제안하다, 시사하다, 제시하다, 암시하다, 제의하다
induced	명사와 결합하여 「~의 원인의」 뜻을 만듦
conflict	갈등, 분쟁, 충돌, 투쟁
fed	feed의 과거·과거 분사형, 연방 준비 제도, 연방의(Federal)
curse	저주, 욕설, 재앙
disappointment	실망, 낙담
helpless	무력한, 속수무책인, 난처한, 가여운
construction	건설, 공사, 건축, 건립
zeal	열의, 열기, 혈안
responsible	책임이 있는, 담당의, 원인이 되는, 역할을 하다, 주범의
indicated	indicator에 지시된, 바람직한
groups	품종분류군
positive	긍정적인, 확신있는, 양성의, 적극적인, 확실한
vengeance	복수, 원수 갚기, 앙갚음
fort	요새, 포트
club	클럽, 팀, 동아리, 구단, 골프채
cure	치료, 치유, 고치다, 해결하다
stout	튼튼한, 뚱뚱한, 굵직한, 커다란
gracious	우아한, 친절한, 점잖은, 관대한, 도움이 되는
include	포함하다, 포괄하다, 함유하다
flood	홍수, 침수하다, 범람, 쏟아짐, 수해
satisfy	만족시키다, 충족시키다, 이루다, 다하다, 충분하다
agony	고민, 고통
implied	함축된, 언외의, 상정상의
stupid	어리석은, 바보, 시시한
grain	곡물, 곡식, 알갱이, 낟알, 나뭇결
enjoyment	즐거움, 즐김
wearing	소모시키는, 점점 약화시키는, 착용의
indifference	무관심, 냉담
conceal	숨기다, 감추다
horizon	지평선, 수평선
therein	그 안에, 그 점에, 그 정보로
precisely	정확히, 정밀하게, 명확하게
assume	생각하다, 가정하다, 추측하다, 추정하다, 맡다
registered	등록된, 등기의
estimate	추정하다, 예상하다, 전망하다, 평가하다, 견적하다
steep	가파른, 급격한, 경사, 극단적인
route	길, 방법
visitor	방문자, 관광객, 관람객, 손님
closer	더욱, 가까워, 자세히, 가까이, 다가가다
harmony	조화, 일치, 화합
non	~아닌, ~없는, 금지된
thunder	천둥, 썬더, 굉음을 내다
wire	전선, 배선하다, 철조망, 전화, 송금하다
graceful	우아한, 얌전한, 기품 있는
crept	creep의 과거·과거 분사형
greece	그리스
childhood	어린 시절, 유년기, 유년시절
knee	무릎, 무릎치기, 무릎으로 치다
saddle	안장, 올라타다
supplies	저장품, 물품
weeping	눈물을 흘리는, 진물이 나는, 비가 오는
mostly	대부분, 주로, 거의
unconscious	무의식의, 의식을 잃은
mutual	상호적인, 서로의, 공동의
scorn	경멸하다, 냉소적이다, 업신여기다, 모멸감
external	외부의, 대외적인, 외관의
software	소프트웨어, 프로그램
losing	잃은, 손해보는, 지는, 패배, 잃어버린
universe	우주, 세계
clock	시계, 시간, 자명종, 기록, 출근하다
instruction	지시, 설명, 교육, 교본, 방법
injury	부상, 손상, 상처, 피해
receipt	영수증, 증서
dearest	가장 사랑하는 사람
sore	아픈, 상처, 비굴한
earliest	가장 앞선, 초기의, 최초의
finest	경찰, 경찰관들, 경관들
enable	가능하게 하다, 할 수 있게 하다
discipline	기강, 훈련, 징계, 규율, 훈육
introduction	도입, 소개, 서문, 머리말, 입문
converted	개종한, 전향한, 개장한
wilderness	황야, 자연
confused	혼란한, 헛갈리는, 당황한, 착각한, 어리둥절한
fancied	상상의, 공상의, 가공의
slip	미끄러지다, 빠지다, 실수, 떨어지다, 깜빡하다
revolution	혁명, 회전, 변혁
wedding	결혼, 웨딩
farmer	농민, 농부, 농장주, 농업, 파머
silently	조용히, 말 없이, 잠자코, 침묵
wept	weep의 과거·과거 분사형
behalf	~을 대신하여, ~을 위하여, ~의 입장에서
reckon	전망하다, 계산하다, 간주하다
uncertain	불확실한, 불투명한, 불안한
neglected	무시된, 방치된, 경시된
stroke	뇌졸중, 발작
exquisite	정교한, 절묘한, 우아한
engagement	연대, 약혼, 교전, 약속, 참여
dirty	더러운, 지저분한, 더러워지다, 비열한, 추잡한
rolling	구르기, 구르는, 롤링, 몰려오는, 회전
platform	플랫폼, 정강, 승강장, 기반, 연단
messenger	메신저, 배달, 사자, 심부름꾼
privilege	특권, 영광, 특례, 혜택
admirable	감탄할만한, 훌륭한, 칭찬할 만한
mischief	장난, 악영향, 손해
physician	의사
organized	비품 등을 갖춘, 정리된, 정돈된
covering	덮는, 감추는, 포함하는, 취재하는, 맡다
student	학생, 생도
daring	대담한, 감히, 용감한
cave	동굴, ~에 굴을 파다, 움푹 들어가다
convey	전달하다, 전하다, 나타내다, 의미하다
he'll	he will, he shall의 단축형
sincere	진지한, 진실한, 진심의, 성실한, 솔직한
tradition	전통, 전해지는, 관습
gravely	엄숙히, 장엄하게, 진지하게
combined	합친, 총, 결합한, 전체, 연합의
gallant	용감한, 씩씩한, 연애의
sensation	센세이션, 감각, 느낌, 감동
travelling	이동, 이동하는(순회하는)
submit	제출하다, 제시하다, 복종하다, 굴복하다
tragedy	비극, 참사, 불행, 안타까운, 재난
specific	특정한, 구체적인, 특별한, 상세한, 분명한
commander	사령관, 지휘관, 공로훈장, 작위
inn	여관, 주막
stiff	뻣뻣한, 치열한, 강한, 시체
accompany	동행하다, 함께 ~하다, 수반하다, 수행하다, 따르다
score	점수, ~점, 득점하다, 기록하다, 얻다
virgin	처녀, 성모, 순수한
farewell	작별, 안녕
paradise	천국, 파라다이스
hunger	기아, 갈망
favorite	좋아하는, 마음에 드는, 인기 있는, 우승 후보
criticism	비난, 비판, 비평, 혹평
proprietary	소유자, 소유주의, 소유자의
customs	세관, 관세
cotton	면, 목화, 솜, 면화, 무명
hospital	병원
outward	표면상의, 밖으로 향하는, 외부
impressed	감명 받는, 인상 받는, 감동 받는
plains	평원 인디언(Plains Indian)의
rent	빌리다, 임대하다, 세, 집세, 렌트
prey	먹이, 잡아먹다, 사냥, 희생, 포획
longing	갈망하는, 열망, 동경하는
musical	뮤지컬, 음악의, 곡의
satisfactory	만족스러운
ridiculous	말도 안 되는, 터무니없는, 어리석은, 우스운, 우스꽝스러운
sheet	종이, ~장, ~지, 판, 시트
disgrace	불명예, 부끄러운, 명예를 더럽히다
colored	~색의, 채색된, 컬러, 유색인, 물든
shouldn't	should not의 단축형
originally	원래, 본래, 처음에는, 처음부터
papa	아빠
gas	가스, 휘발유, 기체
inevitable	불가피한, 피할 수 없는, 필연적인
extensive	광범위한, 대규모의, 집중적인, 긴, 넓은
leisure	여가, 레저, 한가한
deadly	치명적인, 위험한, 심각한, 무서운
chin	턱
glow	빛나다, 불이 켜지다, 홍조, 석양, 활기가 넘치다
jealousy	질투
leaf	나뭇잎, 잎, 리프, 잎사귀
publication	출판, 발행, 발표, 간행물, 발간
hostile	적대적인, 적의, 호전적인, 강경한, 부적당한
railway	철도
translation	번역, 통역, 해석, 해독, 환산
procession	행렬, 행진, 진행
pound	파운드, 많은, 살, 두드리다, 동물보호소
elected	선출된, 당선된, 뽑힌, 선택, 승리
sunk	가라앉은, 사라지는, 쏟아 부은
eastern	동부의, 동쪽의, 동양의, 동구의
citizen	시민, 국민, 주민
beach	해변, 바닷가, 해수욕장, 백사장, 호숫가
starting	출발, 개시
funeral	장례의, 장의
flour	밀가루, 가루
feature	특징, 출연하다, 기능, 작품, 장편
correspondence	서신 교환, 보고, 연락, 통신문, 일치
reserve	보유하다, 예약하다, 준비의, 보호지역, 예비
roar	소리지르다, 굉음을 내다, 환호성, 포효하다, 급격히 이루어지다
romantic	로맨틱한, 낭만적인, 연애의, 낭만주의의, 비현실적인
hut	오두막
strangely	이상하게, 기묘하게, 특이하게
absorbed	열중한, 흡수된, 합병된
propose	제안하다, 제의하다, 제시하다, 청혼하다, 신청하다
bark	짖다, 나무 껍질, 헛다리 짚다, 말만 그렇다, 고함을 치다
reception	환영, 수신, 리셉션, 접수
pleasing	즐거운, 유쾌한, 기분 좋은, 만족스러운
wake	깨다, 일어나다, 눈을 뜨다, 각성하다
research	연구, 조사, 탐사, 탐구
monarch	군주, 거물
clothing	옷, 의류, 복장
dollar	달러
illness	질병, 병, 질환
calmly	침착하게, 조용히, 냉정하게
heartily	진심으로, 많이
pressing	긴급한, 시급한, 누르기, 절박한, 집요한
daylight	낮, 일광, 공공연함
jest	농담
abruptly	갑자기, 돌연히
comment	말, 발언, 언급하다, 논평, 의견
metal	금속, 메탈, 합금
solution	해결책, 방안, 해법, 솔루션, 용액
pretended	자칭의, 거짓의, 말해진
sixteen	열여섯
assembly	국회, 조립, 의회, 집회, 입법부
tobacco	담배, 흡연
entity	실체, 본질, 존재
dwelling	사는, 주거, 주택
depart	출발하다, 떠나다, 벗어나다, 죽다
swung	swing의 과거·과거 분사형
bitterly	심하게, 몹시
alteration	변경, 개조, 수정
colony	식민지, 집단, 정착촌
wing	날개, 진영, 건물, 부서, 지느러미
peaceful	평화적인,평화로운,편안한, 평화적인, 평화로운, 편안한
lion	사자, 라이온
alarmed	놀란, 두려워 하는, 겁에질린
furnish	갖추다, 제공하다, 붙박이, 퍼니시
resting	쉬고 있는, 휴면 중인, 증식하고 있지 않는
accused	비난 받은, 혐의를 받다, 피고인, 고소했다, 고발된
culture	문화, 문명, 배양
dwelt	dwell의 과거·과거 분사형
trick	속이다, 묘기, 재주, 장난, 요령
trusted	신뢰받고 있는
column	칼럼, 기둥, 세로의 난, 소속, 열
financial	금융의, 경제의, 재정적인, 재무의, 회계의
cunning	교활한, 교묘한, 노련한, 잔꾀
preparation	준비, 대비
drama	드라마, 연극, 극, 연출, 극적 사건
joke	농담, 장난, 놀리다, 재담
mist	안개, 흐려지다
hypertext	하이퍼 텍스트
shell	포탄, 껍질, 조개, 탄피, 돈을 낭비하다
medicine	약, 의학, 의사직, 의술
proofread	교정보다, 교정을 보다, 교정하다
nest	둥지, 보금자리, 살다
reverence	존중, 공경, 존경
situated	위치해 있는, 자리잡고 있는, 소재하는
conceive	임신하다, 생각하다, 만들어지다
appointment	임명, 약속, 예약
fetch	낙찰되다, 가져옴, 데려옴
tomb	무덤
candle	초, 양초
offence	범죄, 위반, 악의, 공격, 반칙
coarse	상스러운, 거친
heap	더미, 쌓다, 엄청난, 수많은
mixture	혼합, 섞인, 혼합물
model	모델, 모형, 모범, 방식, 방법
men's	남성용 사이즈, 남성복, 남자용 화장실men's room
defect	결함, 탈주, 장애, 이탈
destined	운명의, ~할, 향하는, 틀림없는, 예정된
occasional	가끔의, 필요할 때만, 때때로
fourteen	열넷
hint	시사, 넌지시 말하다, 밝히다, 힌트, 미량
solicit	간청하다, 권유하다, 청구하다
objection	반대, 이의, 거부
craft	공예, 만들다, 비행기, 선박, 솜씨
acid	산, 신랄한, 신, LSD
namely	즉, ~와 같은, 소위
Asia	아시아
neglect	무시, 소홀히 하다, 게을리하다, 방치하다, 등한시하다
data	자료, 데이터, 정보
weapon	무기, 총기
confessed	인정된, 정평있는, 명백한
repose	휴식, 정지, 수면
pink	분홍색, 핑크색
user	사용자, 쓰는 사람, 가입자, 유저
grandfather	할아버지, 조부
income	소득, 수입, 수익
i.e.	생각, 아이디어, 방법, 의견, 개념
vigorous	활발한, 격렬한
accepting	흔쾌히 받아들이는, 솔직한, 승낙
bishop	주교, 비숍
lightning	번개, 벼락, 전율
compressed	압축된, 꽉 눌린, 간결한
sport	스포츠, 운동회, 운동, 경기, 종목
powder	가루, 파우더, 분말
beds	베드퍼드셔(Bedfordshire)
orange	오렌지색, 오렌지, 주황색, 귤
painting	그림, 페인트칠, 페인팅
shout	소리지르다, 외치다, 큰 소리, 환성, 외침
bath	목욕, 목욕물, 욕조, 욕실
careless	부주의한, 경솔한, 조심성 없는
chap	녀석, 갈라지다
derivative	파생적인, 파생어, 파생물
primitive	원시의, 초생의, 원초적인, 발달되지 않은
doorway	문간, 출입구
vulgar	저속한, 천박한, 통속적인, 비속한, 점잖지 못한
sunset	일몰, 해질녘, 노을, 말기의
convenient	편리한, 간편한, 손쉬운, 알맞은
mail	이메일, 부치다, 우편
wrapped	매우 기뻐하는, 열중하는, 억누르는
abode	주소, 체류, 거처
paint	그리다, 페인트, 칠하다, 물감, 색칠하다
surrender	항복하다, 포기하다, 인도하다, 자수하다, 몸을 맡기다
establish	설립하다, 세우다, 수립하다, 확립하다, 제정하다
mild	온화한, 가벼운, 순한, 부드러운
promptly	신속히, 즉시, 정각
appearing	~인 듯한
department	부서, 부, 과, 학과, 성
parish	교구
nay	아니, 거부, 아니요
lit	불을 밝혔다, 켜졌다, 빛났다, 문학
handkerchief	손수건
basket	바구니, 바스켓, 광주리
easier	easy의 비교급, 더 쉬운
deserve	자격, 만하다, 마땅히, 가치, 싸다
quit	그만두다, 끊다, 포기하다, 떠나다, 관두다
assurance	보장, 확언, 확신, 주장
mirror	거울, 반영하다, 귀감
plot	음모, 줄거리, 구상, 플롯, 구분하다
yer	w 뒤에서의 -er의 별형, your
upward	올라가는, 증가하는, 위쪽으로
sadly	안타깝게도, 슬프게, 애석하게도, 유감스럽게도, 불행히도
secretary	장관, 비서, 차관, 사무총장, 간사
modest	겸손한, 적당한, 수수한, 정숙한
dish	음식, 요리, 접시, 식기
straw	빨대, 짚, 지푸라기, 사소한
net	순~, 그물, 인터넷, 네트, 망
advised	신중한, 곰곰이 생각한, 기별을 받은
heavenly	천상의, 하늘의, 신성한
proceeding	진행, 절차
impatient	서두르는, 참을성 없는, 초조한, 짜증을 내는
warmth	따뜻함, 온기, 친밀함
certainty	확실, 확신
restless	불안한, 가만히 있지 않는
meantime	한편, 그 동안, 당분간
salvation	구제, 구원, 구조
experiment	실험, 시도, 시험
today	오늘날, 오늘, 현재, 요즘, 지금
tremendous	엄청난, 대단한, 거대한, 많은, 소름끼치는
moonlight	달빛, 야간 아르바이트를 하다
intend	의도하다, 계획하다, 하려고 하는, 의미하다
cultivated	경작된, 재배된, 교양이 있는
flushed	홍조를 띤, 흥분한
rocky	로키, 바위가 많은, 장애가 많은, 불안정한
pious	독실한, 경건한
wont	습관, ~하는 습관이 있다, ~에 익숙한
steam	증기, 찌다, 화내다, 스팀, 열을 내다
improvement	개선, 향상, 발전, 개량, 진보
ned	남자 이름, New English Dictionary
treasury	재무부, 국채, 재정, 금고주
perpetual	영구적인, 영원한, 끊임없는, 집요한
trained	훈련받은, 교육된, 배웠다, 숙련된, 준비했다
affectionate	다정한, 애정 어린
dispute	분쟁, 논쟁, 문제, 갈등, 쟁의
poison	중독되다, 독, 독약, 포이즌
proposition	제안, 명제, 프로포지션, 주장
maybe	아마, 어쩌면, 아마도, 혹시, 그럴지도 모른다
rifle	소총, 약탈하다, 날리다
parting	이별, 사별, 분리
shield	방패, 보호하다, 감싸다
employ	정규직, 자영업자, 고용하다, 사용하다, 일
talent	재능, 인재, 탤런트, 연예인, 소질
climate	기후, 날씨, 분위기, 풍토
unlike	~와는 달리, 닮지 않은
recover	회복하다, 회수하다, 되찾다, 찾아내다, 복구하다
mate	짝, 친구, 짝짓기, 마테 차, 항해사
arrange	준비하다, 마련하다, 정리하다, 배치하다, 계획하다
puzzled	골치 아프게 하는, 이해하지 못하고 있는, 곤혹스러운
committee	위원회
aged	세의, 노인, 나이, 대의, 오래된
ohio	오하이오, 미국 북동부의 주, 오하이오 강
ghost	유령, 귀신, 영혼
b	영어 알파벳의 둘째 자, B자 모양, 「나」음
effective	효과적인, 효력있는, 효율적인, 유효한, 유능한
distinguish	구별하다, 구분하다, 분간하다, 특징짓다
manifest	나타나다, 승객 명단, 분명하게 하다, 매니페스트
comparatively	비교적, 상대적으로
esteem	생각하다, 존경하다, 평가하다, 존중하다, 여기다
blew	blow의 과거형
revelation	폭로, 계시, 적발
wash	씻다, 세탁하다, 밀려오다, 닦다, 감다
recognition	인정, 인식, 수여, 승인, 평가
confession	고백, 자백, 고해, 진술서
clay	진흙, 클레이, 점토
nonsense	말도 안 되는, 터무니없는, 허튼소리, 난센스, 바보같이
trunk	트렁크, 코, 몸통, 줄기, 간선
management	경영, 관리, 사측, 운영, 기획사
undoubtedly	의심할 여지없이, 분명히
dried	말린, 말라붙은, 건조한
coal	석탄
stolen	도난당한, 훔친, 도둑 맞은, steal의 과거 분사형
earthly	지상의, 세속적인, 이 세상의
restore	복원하다, 회복하다, 되찾다, 되돌리다, 재건하다
indirectly	간접적으로, 우회적으로
selfish	이기적인, 자기 중심적인
renewed	새롭게 한, 회복된, 갱신된
canoe	카누
protest	시위, 항의, 반대하다, 저항, 데모
vice	대리의, 악
temporary	임시의, 일시적인, 임시 고용
pile	쌓다, 더미, 모으다, 저축하다
chapel	예배당, 채플, 장례실
moderate	온건한, 적당한, 중도의, 완화하다, 중간의
spell	철자하다, 마법, 의미하다, 기간, 초래하다
upright	똑바로, 직립한, 올바른
area	지역, 분야, 구역, 면적, 지방
bone	뼈, 골격, 유골
solitude	고독, 외로움
formal	공식적인, 정식의, 정규의, 정장, 형식적인
greatness	위대함, 탁월함, 굳건함
struggling	기를 쓰는, 분투하는, 몸부림치는
Monday	월요일
reproach	비난하다, 나무라다
altered	드래그 레이스용 개조차, 핫 로드
grim	우울한, 어두운, 냉혹한, 으스스한
venice	베니스, 이탈리아 북동부의 항구 도시
federal	연방의, 연방 정부의
editor	편집자, 편집장, 언론인, 에디터
desirable	바람직한
acknowledge	~을 인정하다, 알다, 확인하다, 감사하다, 승인하다
motionless	움직이지 않는, 가만히 있는, 정지한
remedy	치료하다, 구제하다, 요법, 처방하다
pursue	추구하다, 추진하다, 계속하다, 추적하다, 쫓다
representative	대표적인, 국회의원, 대의원의, 직원, 대리인
pole	장대, 기둥, 극
gladly	즐거이, 기꺼이, 쾌히
linen	리넨, 아마포, 속옷류
vital	중요한, 필수적인, 주요한, 생명과 관련된
sink	침몰하다, 가라앉다, 싱크대, 빠지다, 격침시키다
pacific	태평양, 퍼시픽, 온화한
hopeless	가망없는, 절망적인
gratefully	기꺼이, 감사하여
president	대통령, 사장, 회장, 총장, 위원장
ward	워드, 막다, 구(區), 병동
nephew	조카
ms	~씨, 부인, 석사학위, 다발성경화증
cheer	응원하다, 환호하다, 격려하다, 건배, 기운이 나다
bloody	유혈의, 피의, 잔혹한, 빌어먹을, 엄청난
siege	포위 공격, 포위 기간, ~을 포위하다
justified	정당한 이유가 있는, 행의 길이에 꼭 맞게 들어간, 정당한
atlantic	대서양, 아틀란틱
stomach	배, 위, 마음, 즐기다, 참다, 견디다, 먹을(넘길) 수 있다
improved	개선된, 향상된
admire	존경하다, 감탄하다, 칭찬하다, 동경하다, 숭배하다
openly	공개적으로, 공공연히, 드러내놓고
abide	머물다, 살다, 머무르다
advancing	전진하는, 발달의
polly	여자 이름, 수정이 필요하게 된 에코 부분
modification	수정, 변경, 조절
dramatic	극적인, 급격한, 인상적인, 드라마틱한, 연극의
statements	계산서류
upstairs	위층, 2층
varied	다양한, 갖가지의, 다양화된
letting	셋집, 임대 맨션, 임대
wilson	윌슨
descent	혈통, 하강, 기원, 유래, 강하
whither	어디로, 어디든 ~하는 쪽으로, 목적지
envy	부러워하다, 질투하다, 선망
load	싣다, 짐, 부담량, 장전하다, 부자인
pretend	~척하다, 가장하다, 흉내내다, 가짜의, 속이다
brass	고급 장교, 금관 악기, 놋쇠
internal	내부의, 국내의, 내정의, 내장, 체내의
furious	격노한, 격렬한
curtain	커튼, 막, 장막
healthy	건강한, 건강에 좋은, 건전한, 위생적인, 유익한
obscure	불분명한, 무명의, 가리는, 희미한, 이해하기 어려운
summit	정상 회담, 최고봉, 지도자
alas	아아, 유감스럽게도
fifth	5번째의, 5분의 1
center	센터, 중심의, 시설, 집중하다, 가운데
faced	직면, ~얼굴, 마주치다, 처하다, 맞서다
cheap	싼, 저렴한, 싸구려의, 손쉬운, 인색한
colonel	대령
egyptian	이집트의, 이집트인의, 이집트인
contest	대회, 콘테스트, 경쟁하다, 선거
owned	~의 소유인, ~이 소유하는
exclusion	배제, 제외, 배타, 소외
seize	잡다, 장악하다, 빼앗다, 포착하다, 몰수하다
springs	스프링스, 한때 석탄, 후에 금
alter	바꾸다, 변경하다, 수정, 쇠약해지다
landing	상륙, 착륙, 선창
fence	울타리, 펜싱, 담, 펜스, 막다
glimpse	보다, 잠깐보다, 훑어보다, 관측
statue	동상, 조각상, 상, 입상
contract	계약, 계약서, 맺다, 수축하다, 걸리다
luxury	고급의, 명품, 사치스러운, 호화로운, 럭셔리
artillery	대포, 포병
saving	구조하는, 절약하는, 저축, 절감하는, 아끼는
fro	저쪽으로(to and fro)
string	줄, 일련, 현악, 조건, 묶다
combination	조합, 결합, 콤비네이션, 연합, 배합
faded	쇠퇴한, 색이 바랜, 시든
arrest	체포하다, 구속하다, 검거하다, 억류하다, 저지하다
temperature	온도, 날씨, 열
strict	엄격한, 강력한, 철저한, 엄중한, 지나친
contented	만족한, 중요한
professional	전문의, 프로의, 직업의
intent	의도, 의향, 열중하는, 고의로
injured	부상한, 다친, 사상자, 상처 입은
neighborhood	동네의, 이웃, 인근, 주변
andrew	남자 이름, 예수의 12사도 중 한 사람, 안드레
abundance	풍부, 대량, 다양한, 양
smoking	흡연, 담배를 피우는, 연기 나는
yourselves	당신 스스로
medical	의료의, 의학의, 의사의, 건강의, 진료
garrison	기지, 부대, 수비대, 주둔하다, 배치하다
corps	단체, 부대
heroic	영웅의, 비장한, 숭고한, 위대한, 단호한
inform	알리다, 통보하다, 정보를 제공하다
agitation	동요, 불안, 흥분
prominent	유명한, 두드러진, 탁월한, 뛰어난, 실력 있는
institution	기관, 협회, 부처, 학회
embrace	포용하다, 받아들이다, 포옹하다, 이용하다, ~을 포함하다
closing	닫는 것, 잠금쇠, 끝내는
damaged	손상된, 피해, 파손, 훼손, 상했다
pack	싸다, 꽉 들어찬, 짐, 갑, 채우다
eldest	장남, 장녀, 맏이인, 연장자
anguish	고통, 고민, 분노, 괴로워하다, 비통
surrounding	둘러싸는, 주변의, 관련된, 환경, 측근
obviously	분명히, 명백히, 확실히, 당연히
strictly	엄격히, 철저히, 전적으로, 순전히, 강력히
capture	잡다, 포착, 체포, 사로잡다, 붙잡다
inquire	문의하다, 조사하다
ample	풍부한, 충분한, 넓은
remainder	나머지, 남은, 잔여
justly	정당하게, 당연히, 올바르게
recollection	기억, 회상
deer	사슴
bedroom	침실
purely	순수하게, 순전히, 전적으로
bush	부시, 덤불, 숲, 관목, 수풀
thyself	그대 자신을, 그대는, 그대 자신
joint	공동의, 합동의, 합작의, 관절, 조인트
refer	말하다, 언급하다, 부르다, 가리키다, 회부하다
madam	~ 부인
railroad	철도
spake	speak의 과거형
respecting	~에 관하여
jan	남자 이름, 여자 이름, January
weep	울다, 눈물을 흘리다, 슬퍼하다
identify	확인하다, 밝히다, 식별하다
discharge	제대하다, 방출하다, 퇴원하다, 해고하다, 이행하다
bench	벤치, 의자
ralph	남자 이름, 랄프, 토하다, vomit
heir	후계자, 상속인, 후손
oak	참나무, 오크
rescue	구조하다, 구하다, 구제하다, 수색하다
limit	제한, 한계, 한도, 한정하다, 범위
unpleasant	불쾌한, 싫은, 무례한, 재미없는
anxiously	걱정스럽게, 애타게
innocence	결백, 순수
awoke	깼다
expectation	기대값, 기대치, 기대, 예상, 전망
incomplete	불완전한, 불충분한, 미완성의
program	프로그램, 계획, 과정, 프로
reserved	남겨 둔, 예비의, 따로 둔
secretly	비밀, 몰래
we've	we have의 단축형
invention	발명품, 발명, 창작, 고안
disagreeable	동의하기 힘든, 불쾌한, 마음에 들지 않는
piano	피아노
purse	지갑, 핸드백,  가방, 오므리다
persuade	설득하다, 하게 만들다, 납득시키다, 기대하다, 종용하다
deprived	불우한, 가난한, 곤궁한
electric	전기의, 전자의
endless	끝없는, 많은, 무한한, 장황한
interval	간격, 기간, 휴식 시간, 구간
chase	쫓다, 쫓아내다, 추격, 체이스, 추적
invisible	눈에 보이지 않는, 투명한, 감출 수 있는
well-known	잘 알려진, 친한
occupy	점령하다, 차지하다, 들어서다, 거주하다, 몰두하다
jacob	남자 이름, 야곱, Fran?ois, 자코브; 노벨 생리학 의학상. JACOB-MONOD
gown	드레스, 의상, 가운, 야회복
cruelty	잔인함, 학대
lock	잠그다, 자물쇠, 갇히다, 닫다, 고정시키다
lowest	최저의, 최하의, 최소의
hesitation	망설임, 주저, 피함
withdrew	withdraw의 과거형
proposal	제안, 안, 계획, 제의, 청혼
destiny	운명, 숙명
commons	평민, 서민, 서민 계급
foul	나쁜, 욕설, 반칙, 파울, 실패하다
loaded	짐을 실은, 만원인, 물건을 채운
amidst	~중에, 가운데, 속에서
commanding	지휘하는 입장에 있는, 당당한, 위엄 있는
madness	광기, 미친 짓, 열중, 정신 착란
happily	행복하게, 기꺼이, 다행히도
temptation	유혹
subsequent	그 후의, 다음의, 뒤이은, 이어서
breathed	무성의, 성대를 진동시키지 않는, 무성음의
willingly	기꺼이, 자진해서, 고의적으로
youthful	젊은, 어린, 기운찬, 젊은이의, 이른
bells	나팔 모양의, 나팔 바지, 나팔식의
spectacle	광경, 장관, 구경거리, 안경
uneasy	불안한, 불편한, 쉽지 않은, 불쾌한
shine	빛나다, 빛, 비치다, 구두를 닦다
formidable	무서운, 만만찮은, 위협적인
stately	위엄이 있는, 장엄한, 위풍당당한
machinery	기계, 조직, 기구, 장치
rushing	격한, 성급한, 활발한
attractive	매력적인, 매혹적인
product	제품, 상품, 생산물, 물건, 결과물
economic	경제의, 경기의
sickness	질병, 병
dashed	낙심한, 굉장히, 실망한
engine	엔진, 동력, 기관, 기관차, 기계
ashore	해변에, 상륙하다, 호숫가
theirs	그들의 것
international	국제적인, 인터내셔널, 국제의, 국제간의
leather	가죽, 피혁
interfere	간섭하다, 방해하다, 지장을 주다, 침해하다, 충돌하다
subtle	미묘한, 섬세한, 교묘한, 미세한, 민감한
waved	파형의, 기복이 있는, 물결 무늬가 있는
slope	경사, 스키장, 슬로프
floating	떠 있는, 부유, 부동적인
worry	걱정하다, 우려하다, 염려, 불안, 근심하다
violently	폭력적으로, 격렬히
donation	기부, 기증, 모금, 헌혈, 성금
steamer	기선, 증기로 움직이는 것, 시루
specified	명확히 서술된, 지정된
learnt	배운, 교훈을 얻은, 암기한
designed	계획적인, 고의의, 도형을 뜬
roger	알았다, 오케이, 성교하다
timber	목재
heed	주의하다, 주의, 유의
jackson	잭슨, 남자 이름
vivid	생생한, 발랄한, 극명한
woe	비통, 비애, 아
calculate	계산하다, 추정하다, 산정하다, 측정하다, 생각하다
killing	죽이는, 살해, 죽을 것 같은, 도살, 죽음
laura	라우라, 여자 이름, 로라
wasted	헛된, 황폐해진, 쇠약해진
trifle	사소한 일, 가지고 놀다
funny	재미있는, 웃기는, 이상한, 농담조의, 유쾌한
philosopher	철학자
insult	모욕하다, 욕보이다, 무례함
den	굴, 동굴, 남자 이름
representation	대표, 나타내는, 표현, 대의권, 대리
incapable	무능한, 불가능한
eloquence	웅변, 달변, 웅변술
dine	식사를 하다
ann	여자 이름, annals, annual
sensitive	민감한, 섬세한, 감성적인, 신경을 쓰는, 신경질적인
robin	로빈
appetite	식욕, 관심, 입맛, 성향
wishing	소망을 이루어 주는 힘이 있다고 하는, 소원
picturesque	그림같이 아름다운, 생생한
douglas	남자 이름, 더글러스, 영국의 작가
courtesy	예의, 호의, 의례적인, 정중하게, 무료의
flowing	흐르는, 유창한, 솟아나는
remembrance	기억
sphere	영역, 분야, 범위, 천체, 구
murmur	중얼거리다, 잡음
elegant	우아한, 훌륭한
honourable	훌륭한, 명예로운
stopping	중지, 차단벽, 휴지
guilt	죄책감, 유죄
welfare	복지, 보호, 행복, 후생
fishing	낚시질, 어업, 어장
perish	사라지다, 죽다
sober	술을 끊다, 냉정한, 술이 깨다, 취하지 않은
steal	훔치다, 절도, 빼앗다, 도루, 도용하다
delicious	맛있는, 맛좋은, 달콤한, 즐거운, 먹음직
infant	유아의, 어린이, 초기의
lip	입술, 입, 말뿐인, 립
norman	10세기에 노르망디를 정복한 고대 스칸디나비아인, 노르만 양식의, 노르망디 사람
offended	기분을 상하게 하는, 노한
dost	do의 2인칭·단수·직설법·현재
wheat	밀, 소맥
japanese	일본의, 일본인, 일본어, 일본식
humor	유머, 해학
encounter	만나다, 마주치다, 직면하다, 부딪치다, 충돌하다
marquis	후작, 공작아래 백작 위의 계급
amiable	상냥한, 사랑스러운, 온화한
twilight	트와일라잇, 황혼, 석양, 쇠퇴기
park	박, 공원, 경기장, 주차하다
retire	은퇴하다, 퇴직하다, 퇴역시키다, 퇴임하다, 물러나다
economy	경제, 경기, 이코노미
govern	통치하다, 지배하다, 운영하다, 관리하다, 다스리다
favourable	유리한, 호의적인, 좋은
colors	기, 깃발
stretch	스트레칭, 뻗다, 기지개를 켜다, 늘리다, 이어지다
formation	형성, 구성, 대형, 생김, 지층
immortal	불멸의, 불사의
gallery	미술관, 갤러리, 화랑, 구경꾼
parallel	평행, 유사, 비교, 비슷한
lean	기대다, 기울어지다, 성향, 숙이다, 살코기
tempted	싶은
frontier	변경, 영역, 개척자, 최첨단의
continent	대륙, 극기의, 육지
knock	노크하다, 두드리다, 때리기, 치다, 충돌시키다
impatience	성급함, 안달, 조바심
unity	단결, 통합, 협조, 개체
dealing	관계, 거래, 친한 관계
prohibition	금지, 금주
decent	제대로 된, 품위있는, 좋은, 상당한
fiery	격한, 불같은, 불타는 듯한, 열정적인, 매운
tie	관계, 연결짓다, 동점, 넥타이, 매다
julia	여자이름
albert	남자 이름, 앨버트, 앨버트 호
speedily	재빨리, 서둘러서, 빠르게
major	주요한, 큰, 대기업, 전공의, 메이저
preliminary	예비의, 예선, 최초의
cell	세포, 전지, 독방
void	빈, 공허한, 쓸모 없는
placing	어떤 순위를 차지하는 것, 자본 매출, 순위
prudence	신중, 검약, 현명함
egg	달걀, 알, 난자, 에그
amazement	놀라움
border	국경, 경계, 접해 있다, 인접하다, 가깝다
artificial	인공의, 인위적인, 인조의
hereafter	내세, 이제부터, 내세에
fanny	엉덩이, 여성의 성기, 그럴듯한 이야기
crimes	범죄, 사건, 죄, 불법, 범행
breathe	숨쉬다, 호흡하다, 불어넣다, 살아 있다, 생존하다
exempt	면제하다, 면제된, 면해주다
anchor	앵커, 뉴스캐스터, 정박하다, 지주, 부착하다
chicago	시카고
eminent	저명한, 탁월한
glowing	열렬한, 백열의, 상기된
sunlight	햇빛, 일광
wealthy	부유한, 부자인
seeming	외관상의, 겉보기, 기색
bonaparte	보나파르트
shouting	외침, 갈채, 고함 소리
illustrious	걸출한, 저명한, 뛰어난
curiously	이상하게도
inspiration	영감, 자극, 원천
naval	해군의, 해상의
everyone	모든 사람, 모두, 누구든지, 누구나, 모든 이들
abundant	풍부한, 많은, 과잉
painter	화가, 페인트공
erect	세우다, 건설하다, 수직의, 대두하다
glasses	안경
meanwhile	한편으로는, 반면, ~동안
shooting	사격, 총사냥, 촬영
athens	아테네, 애선스, 그리스의 수도
wagon	마차, 술을 안마시는, 왜건
lend	대출하다, 빌려주다, 돕다, 부여하다
lent	빌려줬다, 사순절
crisis	위기, 문제, 사태, 혼란, 불황
undertake	떠맡다, 착수하다
eh	에
polite	예의 바른, 공손한, 정중한
anna	여자 이름, 안나, 인도, 파키스탄, 미얀마의 옛 화폐
seal	바다표범, 물개, 도장, 결정하다, 봉인
header	헤더, 머리 만드는 기계, 통뚜껑을 만드는 사람
clergy	성직자들
mount	산, 증가하다, 탑재하다, 극복하다, 개최하다
array	다양한, 다수의, 일련의, 진열하다, 배치하다
magazine	잡지, 무기고
loudly	크게, 큰 소리로, 요란하게, 단호하게
bitterness	쓴맛, 괴로움, 쓰라림
texas	텍사스, 미국 남부의 주, 최상부 갑판
guardian	보호자, 수호자, 감시인, 가디언
searching	면밀한, 검사, 수사하는
harsh	가혹한, 거친, 냉엄한, 강경한, 거슬리는
boldly	대담하게, 과감히, 완전히
maurice	남자 이름, 모리츠, Maurice of Nassau, 모리스; William 1세의 아들
kate	여자 이름
lunch	점심, 도시락, 간이 식당
pine	소나무, 수척해지다, 그리워하다
despite	불구하고
injustice	부정, 부당, 불공평, 불법
push	추진하다, 밀다, 노력하다, 누르다, 압력을 가하다
tight	꽉끼는, 엄격한, 빠듯한, 잘, 심한
landscape	풍경, 지역, 지형, 경관, 조경
sue	고소하다
scarlet	주홍, 진홍
abandon	버리다, 포기하다, 유기하다, 폐기하다, 떠나다
artistic	예술적인, 미술적인
mainly	주로, 대부분은, 대개는
measured	신중한, 숙고한, 정확히 잰
loyal	충성스러운, 지지하는, 충실한, 충직한, 성의 있는
boiling	몹시 더운, 끓어오르는, 비등
desirous	원하는, 간절히 바라는, 싶어하는
suited	적합한, 「~의 양복을 입은」의 뜻, 일치한
alliance	동맹, 연합, 협력, 단체
advise	조언하다, 권하다, 알리다, ~하는 게 좋다, 상담하다
waist	허리
sinking	함몰, 침강류, 침강
apprehension	불안, 걱정, 이해
stable	안정적인, 마구간, 외양간, 견실한
gregory	남자 이름, 그레고리우스, 교황
maximum	최대, 최고, 극대
commit	저지르다, 약속하다, 전념하다, 범하다, 헌신하다
hideous	끔찍한, 가증스러운
hamilton	남자 이름, 해밀턴
sweetness	단맛, 사랑스러움, 당신, 부드러움
tore	torus, tear의 과거형
affect	영향을 주다, 작용하다, 감염시키다, ~체하다
shaken	흔들린, 충격적인, 놀란, 동요한, 혼란스런
unworthy	가치 없는, 걸맞지 않은, 가치 없는 사람
significance	중요, 의미, 의의
modified	완화된, 수정된, 한정된
miracle	기적, 기적적인, 놀라운
lieu	장소
peasant	농민, 소작농
considerably	상당히, 많이, 현저히
observing	관찰력이 예리한, 주의심 깊은, 빈틈이 없는
resemblance	유사
extend	연장하다, 확장하다, 늘리다, 뻗다, 미치다
riches	부, 재물, 풍부함
personally	개인적으로, 몸소, 사적으로
morality	도덕성
rebellion	반란, 반항, 폭동, 반역
thread	실, 공통된 주제, 가는 선, 옷
dumb	멍청한, 바보, 벙어리의, 과묵한
inclination	성향, 의향
forbidden	금지된, 금단의, ~형에 처하는
copper	구리, 동전, 경찰
sailor	선원, 해군, 수병, 항해사, 뱃사람
alfred	남자 이름, 알프레드 대왕
response	반응, 대응, 대답, 조치, 응답
imperial	황제의, 제국주의의, 제국의
blank	비어있는, 빈칸, 멍한, 백지의
purity	순수, 순결, 순도
victor	빅터, 승리의
solemnly	진지하게
twenty-four	24
minor	사소한, 소수의, 미성년자, 부전공의, 단조
crimson	심홍색의, 얼굴을 붉힌, 심홍색
republic	공화국
ma'am	엄마, 마님, 아주머니
bargain	흥정하다, 싼 물건, 헐값, 매매 계약
dealt	deal의 과거·과거 분사형
fatigue	피로, 피곤, 마비, 작업복
telephone	전화, 통화
whip	때리다, 휘몰아치다, 휘저어 거품을 내다, 다수당의 원내대표, 잡혀사는
adams	애덤스, 애덤스 산
dislike	싫어하다, 싫음, 좋아하지 않다, 반감
infantry	보병, 보병대, 보병 연대
checked	바둑판무늬의, 체크무늬의, 억지 모음의
countrymen	동포
normal	정상, 평범한, 보통의, 일반적인, 일상적인
shirt	셔츠, 옷
introduce	소개하다, 도입하다, 선보이다, 제출하다, 발표하다
sofa	소파
sweep	휩쓸다, 청소하다, 압승하다, 조사하다
conversion	전환, 환산, 융합, 변화
sketch	스케치, 밑그림, 촌극, 개요, 묘사하다
african	아프리카의, 아프리카인
deserved	당연한, 당연히 받아야 할, 그만한 가치가 있는
answering	응답의, 상응하는
virtuous	덕 있는, 도덕적인
persian	이란의, 이란인의, 이란인
anyway	어쨌든, 어차피, 아무튼, 결국, 그런데
thief	도둑, 절도
driver	운전자, 기사, 드라이버, 견인차, 원인
retain	유지하다, 보유하다, 가지다, 계속하다, 보관하다
constructed	몸매가 좋은
daniel	다니엘, 다니엘서, 명재판관
ut	철저한, ~과 같이, ~대로, Universal time
philadelphia	필라델피아, 미국 펜실바니아주의 도시
conspicuous	눈에 띄는, 두드러지는
channel	채널, 경로, 해협, 통로
nobility	귀족, 고귀함
edith	여자 이름
berlin	베를린, 독일의 수도
editing	편집, 교정
cambridge	케임브리지, 영국 잉글랜드 동부 Cambridgeshire 주의 주도, Cambridge 대학의 소재지
declaration	선언, 신고, 포고
personality	성격, 사람, 인격, 개성
excess	지나침, 초과, 넘는, 여분, 무절제
separation	분리, 이별, 구분, 이탈, 떨어짐
disgust	혐오, 메스꺼움, 넌더리, 분통터지는
ha	하, 헥타르, home automation
accomplish	이루어 내다, 성취하다, 달성하다, 완수하다, 훌륭한
herbert	남자 이름, 놈, 자식
convent	수녀원, 수녀회
rightly	올바르게, 정의롭게, 공정하게
suspended	중단, 유예, 정지, 정학, 중지
reform	개혁, 쇄신, 개정, 개선, 개편
mob	폭도, 집단, 군중
thirst	갈증, 갈망
unnecessary	불필요한, 쓸데없는
gleam	희미하게 빛나다, 비치다
threatening	위협적인, 협박하는, 위험한
palm	손바닥, 야자나무, 종려잎
missouri	미주리, 미국 중부의 주, 미주리 강
filling	채우는, 작성하는, 속에 넣는 것, 메우는, 대신하는
quoth	말하였다
fur	털, 모피
fortnight	2주일
addressing	어드레싱, 어드레스 지정
frightful	무시무시한, 놀랄만한
encourage	격려하다, 장려하다, 권하다, 조장하다, 촉진하다
speaker	연설자, 의장, 연설가, 스피커, 언어 사용자
tribute	감사의 표시, 기리다, 찬사, 조공
procure	얻다, 획득하다, 주선하다
frankly	솔직히, 사실
relieve	완화시키다, 안도하다, 풀다, 해소시키다, 경감하다
unjust	부당한
legislation	법률, 입법, 법률 제정
project	프로젝트, 사업, 계획, 예상하다, 기획
threshold	기준점, 한계점, 입구
morrow	내일, 다음날, 직후
induce	유도하다, 유치하다, 유발하다, 유인하다, ~하게 하다
spear	창
inward	내부의, 내면, 안으로, 중심으로
corresponding	상응하는, 같은, 연락
fairy	요정, 남자 동성애자
conclude	결론짓다, 체결하다, 맺다
clung	cling의 과거·과거 분사형
neat	깔끔한, 멋진, 단정한, 정돈된, 괜찮은
lucky	운이 좋은, 행운의, 다행한, 럭키, 우연한
lap	한 바퀴, 무릎, 앉다, 핥다
session	회의, 회기, 시간, 세션, 개정
torture	고문, 고통을 주다, 괴롭히다
damp	습기가 있는, 찬물을 끼얹다, 물기, 축이다
ridge	산맥, 굴곡, 릿지, 골지다, 기압마루
spoil	망치다, 상하다, 응석을 받아주다, 깨다
liable	책임 있는, ~해야 할, ~하기 쉬운, 여지가 있는
hearty	진심어린, 많은, 기분 좋은, 영양분이 있는
bc	기원전
abraham	아브라함, 남자 이름, 유대 민족의 시조
thoughtful	사려 깊은, 친절한, 생각에 잠긴, 조심하는
favorable	유리한, 호의적인, 좋은
tin	주석, 통조림, 양철, 기호 Sn, 주석을 입히다
horace	호라티우스, 남자 이름
dependent	의존하는, 의지하는, 종속의, 부양 가족
couch	소파, 코치, 잠자리, 표현되다
warrant	영장, 보장하다, 정당화하다
complaint	불만, 불평, 고발, 불편
endeavour	노력
convention	대회, 회의, 협약, 컨벤션, 관습
guarded	신중한, 보호받는, 조심스러운
angle	각도, 관점, 모서리
widely	널리, 가장, 광범위하게, 대부분
illinois	일리노이 주, (약어)Ill, IL
charlotte	여자 이름, 샤를로트, 샬로트
ardent	열렬한, 열심인, 불타는
cow	소, 젖소, 암소
mill	공장, 밀, 제분하다, 방앗간
prejudice	편견, 선입관, 손상, 편향
foremost	으뜸가는, 일류의, 선두의
map	지도, 정하다, 약도, 노선도, 맵
probability	가능성, 확률, 개연성
porch	현관, 문간
lieutenant	중위, 해군 대위, 장교, 보좌, 경위
surprising	놀라운, 놀랄 만한, 놀라게 하는, 의외의
fountain	분수, 식수대, 샘, 수원
sustained	지속된, 한결같은, 지속적인
appropriate	충당하다, 적당한, 적절한
ford	여울, 얕은 곳, 포드
clara	여자 이름
assisted	도와주었다
lewis	남자 이름, 루이스, 쐐기 볼트
rejoice	기뻐하다, 환호하다
extending	전개도
marvellous	놀라운, 경이로운, 멋진
jew	유대인, 이스라엘인
collar	칼라, 목걸이, 깃, 목줄, 목덜미
confident	자신 있는, 확신하는, 확신하고 있는, 자신만만한
hasty	성급한, 서두르는
nigh	가까이에, 거의 가깝게, 가까운
organ	장기, 기관, 오르간, 음경
prose	산문
selection	선택, 선발, 선집
replace	대체하다, 교체하다, 대신하다, 바꾸다, 후임으로 임명되다
saint	성~, 성인, 성자
deliberately	일부러, 고의로, 신중히, 유유자적하며
awe	두려움, 외경, 경외심
beforehand	사전에, 미리, 그 전부터
strife	분쟁, 투쟁, 갈등, 싸움, 쟁의
released	발표했다, 개봉된, 출시했다, 공개했다, 발매했다
compare	비교하다, 비유하다, 비슷하다, 맞먹다
beer	맥주
retorted	뒤로 구부러진
relate	관련시키다, 관계시키다, 연관되다, 연결되다
cheerfully	기분 좋게, 들떠서
pistol	권총
presume	추정하다, 가정하다, 추측하다
velvet	벨벳, 부드러운
wretch	녀석, 불행한 사람, 철면피
susan	여자 이름
pennsylvania	펜실베이니아미국 동부의 주. (약어)Pa., Penn., Penna, PA
stirring	분기시키는, 흥분시키는, 분주한
righteousness	정직, 고결, 고결한 행위
missing	실종된, 없어진, 놓친, 그리운, 부족한
fain	기꺼이 ~하는, 기꺼이, ~은 싫어
facing	표면 단장, 가두리 치장, 금장
fashionable	멋있는, 패션 감각이 있는, 유행의
producing	생산하는, 만들어내는, 제작, 제조, 생성
positively	긍정적으로, 적극적으로
reasoning	논리, 추론, 이성
gravity	중력, 중대함
disturb	방해하다, 혼란시키다, 어지럽히다, 불안하게 하다, 교란하다
sermon	설교, 설법
partner	파트너, 상대, 협력자, 동반자, 제휴하다
association	협회, 연합, 단체, 관련, 조합
abuse	남용하다, 학대하다, 악용하다, 폭행, 욕설
flock	모이다, 떼짓다, 유유상종
niece	조카딸
bodily	신체상의, 스스로, 통째로
oliver	남자 이름, 발로 밟아 움직이는 쇠망치, 달
faculty	교수진, 교직원, 능력, 학부
cannon	대포, 캐논, 허풍
thirteen	열셋
sailing	범주, 항행, 출범
smart	영리한, 스마트한, 현명한, 멋있는
petty	작은, 사소한, 마음이 좁은
prudent	신중한, 분별 있는, 빈틈 없는
caution	주의, 신중함, 경고, 조심, 경계
justify	정당화하다, 그럴만한, 당위성을 지닌, 판시하다
awhile	얼마, 잠깐, 잠시
manuscript	원고, 문서, 손으로 쓴
cigar	여송연, 시가, 엽궐련
warrior	전사, 병사
aught	어떤 일, 영, 무엇인가
inaccurate	정확하지 않은, 확실하지 않은, 틀린
tidings	소식, 보도, 정보
friday	금요일
liquid	액체의, 수분, 유동성의
concept	개념, 생각, 구상
creek	시내, 크리크족, 계곡
lo	보라, 아, 자, Liaison Officer
brush	닦다, 붓, 빗다, 털다, 스치다
download	다운로드, 다운로드하다, 내려받기
specially	특별히, 특수하게
cream	크림
jump	증가하다, 점프, 오르다, 뛰어들다, 뛰다
unwilling	꺼리는, ~하고 싶어하지 않는, 마지못한
adapted	개조된, 개작된, 적합한
combat	전투, 싸우다, 해결, 방지하다, 전쟁
subdued	가라앉은, 완화된, 정복된
jewish	유대인의, 이스라엘의, 유대교의
innumerable	셀 수 없이 많은, 무수한
blowing	통기공에서 나오는 가스 소리, 취입 성형, 재즈 연주
extra	추가의, 여분의, 특별한, 별도로, 임시의
civilized	문명화된, 개화된
japan	일본
pitch	투구하다, 던지다, 음색
cliff	절벽, 벼랑, 낭떠러지
crowned	왕관을 쓴, 관 모양의, 볏이 있는
awkward	어색한, 거북한, 서투른, 난처한, 곤란한
horrid	무시무시한, 무서운, 진저리나는
appreciate	감사하다, 감상하다, 인정하다, 평가, 이해하다
kentucky	켄터키, 주미국 중동부의 주, (약어)Ky., Ken., KY, 켄터키 강
jury	배심, 심사위원
monster	괴물, 몬스터, 괴수
simon	남자 이름, 끌려다니는 사람, 시몬
frozen	얼어 붙은, 동결된, 냉각된, 멈추다, 얼어 죽은
invariably	반드시, 언제나, 변함없이, 불가피하게
dies	날
survive	살아남다, 생존하다, 견디다
literally	말그대로, 문자 그대로, 사실상
consolation	위로, 패자 부활의, 위안
m	영어 알파벳의 열셋째 자, month, medium, minute
phenomena	phenomenon의 복수형
pot	냄비, 화분, 항아리, 단지, 주전자
ellen	여자 이름
briefly	잠시동안, 간단히, 간략하게, 일시적으로
rice	쌀, 밥, 벼
planned	계획된, 정연한, 예정대로의
barbara	여자 이름
respected	훌륭한, 평판있는, 존경받는
sublime	숭고한, 멋진
dropping	적하, 낙하, 낙하물
guy	남자, 사람, 너희들, 친구, 녀석
behaviour	행동, behavior
desolate	황량한, 쓸쓸한, 황폐케하다
penny	페니, 한푼, 돈, 푼돈
adopt	채택하다, 입양하다, 도입하다, 취하다, 적용하다
revenue	매출, 수입, 세입, 수익, 순이익
hired	고용한, 세 주는, 부리려고 채용한
regularly	정기적으로, 규칙적으로, 주기적으로
infringement	위반, 침해, 위배
eagerness	열의, 열망
helping	돕는, 도움, 도와주다, 지원, 기여
investigation	조사, 수사, 감사, 연구
constitutional	헌법의, 헌법상의, 합헌의, 입헌적인
insist	주장하다, 고집하다, 요구하다, 강요하다
inheritance	상속, 계승
latest	최근의, 이번, 최신의, 새로운, 늦어도
leap	도약하다, 건너 뛰다, 상승하다, 발전하다, 갑자기 ~하다
apple	애플, 사과, 뉴욕, 사과나무
visiting	방문, 가는, 찾아오는, 여행, 면회
hasn't	has not의 단축형
pupil	학생, 동공, 제자, 눈동자
totally	완전히, 전혀, 정말, 전적으로, 전부
twisted	비뚤어진, 뒤틀린, 꼬인
discuss	논의하다, 토론하다, 상담하다, 언급, 논란
firing	발포, 발사, 점화
background	배경, 출신, 경력, 바탕
subscribe	구독하다, 가입하다, 찬성하다
tenderly	부드럽게, 친절하게, 예민하게
transcribe	베끼다, 옮겨 쓰다, 복사하다
descend	내려오다, 기원하다, 하강하다, 빠지다, 습격하다
differ	다르다, 차이가 나다, 생각이 다르다, 의견을 달리하다
avail	도움이 되다, 유용하다, 쓸모있다
disaster	재난, 재앙, 사고, 피해, 실패
bet	틀림없이, 내기, 걸다, 베팅, 단언하다
periodic	주기적인, 정기적인, 정기의
bull	황소, 강세의, 거짓말
entertainment	엔터테인먼트, 연예, 오락, 여흥, 즐거움
cursed	저주받은, 벌 받은, 저주받을 만한
raw	날~, 익히지 않은, 날것의, 노골적인
fulfilled	충실한
georgia	미국 동남부의 주, 조지아. (약어)Ga., 그루지아 공화국
virus	바이러스, 병균
log	접속하다, 통나무, 기록하다, 벌채하다
scotch	스코틀랜드의, 상처, 벤 자국
hospitality	환대, 대접, 접대
faintly	희미하게, 힘없이, 어렴풋이
solomon	솔로몬, 대현인, 현인으로 유명함
robbed	속은, 속아넘어간, 부당한 판정이 내려진
cart	카트, 수레, 마차
childish	유치한, 어린아이의
robe	가운, 옷, 예복, 무릎 덮개, 로브
aboard	타고, 배로, 배 위에, 승선하여, 기내에
reflect	반영하다, 반성하다, 반사하다, 비추다, 곰곰이 생각하다
dominion	지배권, 주권, 영토
dreary	음울한, 지루한
serving	음식 시중, 봉사하기, 1인분
complexion	안색, 피부색, 외관
engage	관여하다, 약혼하다, 종사하다, 협상하다, 착수하다
herd	무리, 양치기, 군중
attain	달성하다, 도달하다, 얻다
collect	수집하다, 모으다, 받다, 징수하다, 수신자 부담
pan	팬, 냄비, 프라이팬
borrowed	차용한, 빌린, 다른 데서 따 온
convert	전환하다, 바꾸다, 개종하다, 개조하다, 득점하다
outline	윤곽, 개요, ~의 윤곽을 그리다
blown	blow의 과거 분사형
comprehend	이해하다
opera	오페라
assault	폭행, 공격, 비난, 습격
deceive	속이다, 기만하다, 현혹시키다, 거짓말을 하다
dedicated	헌신적인, 전용의, 몰두하고 있는, 열렬한, 특정한 목적으로 사용되는
hiding	숨기, 감추기, 매질하기
backs	백스
prominently	두드러지게, 현저하게, 눈에 띄게
mourning	애도의, 슬퍼하는
compliment	칭찬하다, 찬사
approval	승인, 동의, 허가, 찬성
breadth	폭, 범위, 효과
withdraw	철회하다, 철수하다, 인출하다, 취소하다, 포기
tune	주파수를 맞추다, 곡, 조율하다, 연주하다, 서로 맞다
compassion	동정, 연민, 측은하게 여기는 마음
polished	광택이 나는, 문질러 닦은, 빛나는
latitude	위도, 자유, 허용 범위
dishes	설거지거리
parent	부모, 학부모, 모회사, 엄마 아빠, 어버이
contrived	부자연스러운, 꾸며낸, 인위적인
delicacy	미묘함, 진미, 별미
akin	동족의, 유사한, 혈족의
f	영어 알파벳의 여섯째 자
betray	배신하다, 배반하다, 드러내다, 밀고하다
resentment	분노, 적의
indemnify	배상하다, ~에게 보장하다, 변상하다
pseud	잘난 체하는 사람
disguise	위장, 가장하다, 숨기다
transcription	전사, 필사, 녹화
document	문서, 서류, 기록, 자료, 문헌
squire	지방의 대지주, ~에게 종자로서 시중들다, 보호하며 따라다니다
punish	처벌하다, 벌을 주다, 응징하다, 체벌하다, 혼내다
glittering	화려한, 번쩍이는, 반짝반짝하는
block	막다, 차단, 블록, 봉쇄, 구역
lots	매우, 훨씬 더, lot
worldly	세상의, 세속적인
elbow	팔꿈치, 팔, 엘보우, 팔꿈치로 밀어젖히며 나아가다
obligation	의무, 채무, 채권, 계약
trifling	하찮은, 사소한
decline	감소하다, 하락하다, 줄다, 거절하다, 떨어지다
attachment	애착, 부착, 첨부
ambitious	야심적인, 의욕적인
filename	파일명
bloom	꽃이 피다, 개화, 블룸
holiday	휴일, 휴가, 명절, 공휴일, 축제일
brute	짐승, 신체적
repair	수리, 고치다, 회복하다, 치료하다, 수선하다
fist	주먹, 움켜쥐다, 철권
recollect	기억나다, 회상하다, 생각나다
eagle	한화 이글스 프로야구단, 독수리, 이글
honorable	명예로운, 훌륭한
significant	중요한, 상당한, 의미심장한, 의미 있는, 중대한
barren	메마른, 불모의, 불임의
guided	안내를 받은, 유도된, 유도 장치가 달린
dense	밀집한, 짙은, 고밀도의, 우둔한
fiction	소설, 허구, 픽션, 꾸며낸 이야기, 꾸민 이야기
recommend	추천하다, 권하다, 권고하다, 제시하다, 소개하다
suspicious	의심스러운, 수상한
seventy	70
educational	교육의
duly	정식으로, 정당하게, 적절히
scripture	성서, 경전, 성경
upwards	이상의, 위로
sworn	맹세한, 선서한, swear의 과거 분사형
nicholas	남자 이름, 러시아·그리스·어린이·선원·나그네 등의 수호 성인, 니콜라우스
horn	경적, 뿔, 호른
brook	브룩, 시내, 허용하다
fund	자금, 투자하다, 펀드
vienna	비엔나, 빈, 독일어명 Wien
lodge	숙박하다, 불만을 제기하다, 오두막, 로지, 박히다
infinitely	무한히, 한없이, 크게
clergyman	성직자, 목사
marshal	육군 원수, 연방보안관, 집결시키다, 마샬
ruled	괘선을 넣은, 지배되는
fiercely	치열하게, 필사적으로
portuguese	포르투갈어, 포르투갈의, 포르투갈인
costume	의상, 복장, 분장, 코스튬
pit	싸우게 하다, 피트, 구덩이
disorder	장애, 질환, ~증, 이상, 무질서
sheer	순전히, 완전히, 순수한, 단순한, 전적인
exalted	고귀한, 지위가 높은, 의기양양한
fare	운임, 요금, 실적을 내다, 상연물
applause	박수, 칭찬
chaucer	초서
remind	상기시키다, 생각나게 하다, 떠올리게 하다, 되새기다
binary	2원체, 2개의, 2진법의
packed	꽉 찬, 혼잡한, 짐을 가득 채운
pillow	베개, 방석
jersey	운동경기용 셔츠, 메리야스 상의, 저지종의 젖소
abbey	대수도원, 애비
nowhere	아무 데도, 어느 곳
anyhow	어쨌든, 아무리 해도
agitated	기분이 동요하고 있는, 세상의 관심을 모으고 있는, 흔들리고 있는
catching	전염성인, 매력적인, 잘 옮는
arrow	화살
tend	~하는 경향이 있다, 돌보다, 간호하다
fitting	적절한, 어울리는, 꼭 맞는, 꽉 끼는
instructed	교육을 받은
elaborate	상세히 말하다, 정교한, 설명하다, 정성들인
corpse	시체, 송장, 효력을 잃은 것
bewildered	당혹한, 갈피를 못 잡은
essence	본질, 정수, 핵심, 에센스, 실체
harold	남자 이름, 해럴드, 공동 묘지에서 어슬렁거리는 사람
elevation	고도, 높이, 향상
realm	영역, 왕국, 범주, 국토
glancing	빗나간, 비스듬한, 번뜩이는
loyalty	충성, 성실, 의리
coin	동전, 만들어내다, 주화, 화폐
clad	입은, clothe의 과거·과거 분사형, ~을 씌우다
staircase	계단
documents	상속받을 권리
extremity	극도, 맨끝, 말단
accord	협정, 합의, 허용하다, 의정서
sally	반격, 출격, 여자 이름
lace	포함하다, 끈, 레이스
tremble	떨다, 흔들리다, 진동하다, 전전긍긍하다
exile	망명, 추방, 도피
gospel	복음, 복음 전도의, 복음 성가
mechanical	기계적인, 자동적인, 기술적인
successfully	성공적으로, 잘, 정확하게, 훌륭하게
scholar	학자, 교수, 지식인
arab	아랍의
temperament	기질, 성격
fred	남자 이름, Alfred, Frederick의 애칭
trap	가두다, 덫, 잡다, 빨아들이다, 과속 감시 장치
likeness	사진, 초상
harbour	항구
jolly	유쾌한, 즐거운, 매우, 비위를 맞추다
generosity	관대함, 아낌없는
ruler	통치자, 왕, 지도자, 지배자, 자
lawrence	남자 이름, 로런스
cake	케이크, 몫
crazy	미쳐있는, 미친, 열광적인, 이상한, 말도 안 되는
sincerity	진실, 성실, 진정성, 성의, 정직
entertain	즐겁게 하다, 접대하다, 제공하다
madame	~부인인, 부인, (약어)Mme
sir	손님, 경, 각하, 선생님, 아저씨
hesitate	망설이다, 주저하다
seventeen	열일곱
lordship	각하, 군주의 지위, 영주권
greeting	인사, 인사말, 환영의 말
feminine	여성의, 여자의, 여자다운
monstrous	엄청난
barely	거의 ~않다, 간신히, 겨우
mansion	대저택, 맨션
facility	시설, 설비, 재능
sarah	사라, 여자 이름
rob	빼앗다, 롭, 털다, 훔치다, 강탈하다
gigantic	거대한
honey	여보, 꿀, 얘, 허니
ladder	사다리, 오르는 길, 단계
ending	끝내다, 결말, 멈추다, 종결, 죽이다
wales	웨일스
sunny	맑은, 햇살의, 밝은, 쨍쨍한
knelt	kneel의 과거·과거 분사형
tyranny	폭정, 횡포
decree	법령, 명령, 포고
stake	지분, 걸다, 말뚝, 제공하다
divide	나누다, 분할하다, 분열시키다, 가르다, 분리하다
dreaming	몽상적인, 꿈을 꾸고 있는, 비몽사몽간의
dignified	위엄있는, 고귀한, 당당한
tread	발걸음, 걷다, 밟다, 짓밟다, 춤추다
viewing	텔레비전 보기, 텔레비전 프로, 보기
defense	국방, 방위, 방어, 안보, 보호
incredible	엄청난, 놀라운, 믿을 수 없는
bidding	입찰, 명령, 호출
brick	벽돌, 블록, 벽돌로 둘러싸다
arch	활모양의, 아치, 주요한
everlasting	영원한, 끊임없는, 끝없는
elect	선출된, 당선자, 뽑다, 선택된, 재선
sprung	spring의 과거·과거 분사형, 술이 거나한, 스프링이 망가진
harder	숭어
winding	감기, 감기기, 굽이친
deductible	공제할 수 있는, 공제 가능한, 공제 금액
magistrate	치안 판사, 사법
respective	각각의, 각자의, ~에 따라, 저마다의, 존경스러운
liquor	주류, 술, 증류주, 용액
imitation	모조품, 모방, 모의, 장식
shy	수줍은, 부끄러운, 내성적인, 모자라는, 쑥스러운
perished	싸늘해진, 마모된, 매우 곤란한
prime	전성기, 주요한, 가장, 한창
studying	공부하는
eighty	80, 80의, 80세의, 80명, 80개
hebrew	히브리인의, 히브리인, 히브리어
unfortunately	불행하게도, 안타깝게도, 유감스럽게도
licensed	인가된, 면허를 받은, 관허받은
fog	안개, 흐릿해지다
coloured	~색의, 채색된, 컬러, 유색인, 물든
consult	컨설팅하다, 협의, 상담하다, 상의하다, 진찰받다
r	영어 알파벳의 열여덟째 자, radius, right, river
warn	경고하다, 주의하다, 조심시키다, 충고하다
taylor	테일러, 영국의 수학자
vile	비열한, 몹시 나쁜, 지독한
phil	남자이름, 「~에 친화적인」 「~에 편드는」의 뜻, 「~을 좋아하는 사람」 「~에 친화력을 가진 물질」의 뜻
legend	전설, 전설적 인물, 신화
shallow	얕은, 얄팍한, 천박한, 피상적인, 깊이가 없는
doom	운명, 파멸, 운명짓다
dreaded	염려하던, 두려워하던
encouragement	격려, 장려, 용기
impatiently	참지 못하고, 조바심하여, 성급하게
scent	향기, 냄새, 향수
irregular	비정규의, 불규칙의, 비정상적인, 불안정
compass	나침반, 컴퍼스
bliss	행복, 환희, 더없는 기쁨
harvest	수확, 추수, 생산, 적출, 채취
promotion	승진, 홍보, 진흥, 판촉, 증진
stove	난로, 스토브, 가스레인지, 버너, 화로
faithfully	성실하게, 충실히, 정확히
anthony	남자 이름, Saint, 성 안토니우스; 돼지 사육자의 수호 성인
excellence	우수함, 장점
transfer	옮기다, 넘겨주다, 갈아타다, 바꾸다, 물려주다
heathen	이교도, 이방인, 교양 없는 사람
poetic	시적인
illustrated	도해가 들어 있는, 사진·삽화가 많이 실린 잡지, 삽화를 넣은
gilbert	길버트, 남자 이름, 기자력의 cgs 전자기 단위
fundamental	근본적인, 기본적인, 펀더멘틀, 중요한, 궁극적인
bundle	끼워팔다, 껴입다, 묶음, 묶다, 많은
rebel	반군, 반란, 반항하다, 반역하다
cultivation	재배, 경작, 양성, 형성
rigid	엄격한, 경직된, 융통성이 없는, 굳어진
tragic	비극적인, 비참한
review	평가, 재검토, 복습, 리뷰, 비평
whereupon	무엇 위에, 그것에 대하여 ~하는 바의, 거기서
terribly	정말, 매우, 지독하게, 심각하게
melted	곤드레 만드레 취한
venerable	존경할 만한, 유서 깊은, 오래 된
cooking	요리, 음식, 만들다, 조리, 익히다
mustn't	must not의 단축형
oppressed	억압된, 학대받는, 학대받고 있는 사람들
australia	호주, 오스트레일리아
revolt	반란, 저항, 반감
swell	부풀다, 팽창하다, 팽창
improve	개선하다, 향상하다, 높아지다, 증진시키다, 나아지다
williams	윌리엄스
goddess	여신
wreck	망가뜨리다, 사고, 난파, 엉망인, 잔해
tennessee	테네시, 미국 남동부의 주. (약어)Tenn., TN, 테네시 주
convince	설득하다, 확신시키다, 납득시키다
bowl	그릇, 볼링, 볼
radiant	빛나는, 환한, 밝은, 눈부신
prussia	프러시아, 프로이센
westward	서부로, 서쪽으로 향하는
indignant	분개한, 화난
refined	세련된, 정제된, 정교한, 차분한, 고상한
unseen	눈에 보이지 않는, 보이지 않는 것, 간파되지 않은
illustration	삽화, 일러스트레이션, 실례
swamp	늪, 압도하는, 일이 많은, 잠기다, 인파로 넘치는
austrian	오스트리아의, 오스트리아 학파의, 오스트리아 학파의 경제학자
saxon	색슨족, 색슨인, 영국인
congregation	신도, 회중, 집회, 교구
nerve	신경, 용기, 뻔뻔스러움, 긴장
undertaking	사업, 맡은, 실시
disclaimer	부인, 거부, 권리의 포기
stare	쳐다보다, 바라보다, 응시하다, 노려보다, 뚫어지게 보다
ascertain	확인하다, 규명하다, 찾아내다
pledge	공약하다, 약속하다, 맹세하다, 서약하다
earn	벌다, 받다, 얻다, 올리다, 얻게 하다
warfare	전쟁, 전투, 싸움, 투쟁
supposing	만약 ~이라면
subsequently	그 후에, 이어서, 이후에
attending	참석, 다니는, 참가, 재학, 주치의
angrily	거세게, 화나서, 격분하여
select	선택하다, 선발하다, 고르다, 선별하다, 엄선된
animated	생기 있는, 기운찬, 싱싱한
industrial	산업의, 공업의
hurriedly	급히, 허둥지둥, 황급히
manhood	남자다움, 남자, 남자임
interpretation	해석, 통역, 설명, 이해, 생각
dressing	소스, 의상, 의복
edinburgh	에든버러, 영국 스코틀랜드의 도시
catherine	여자 이름
challenge	도전, 문제, 난제, 이의를 제기하다, 자극하다
forbid	금지하다, 어렵게하다, 용납하지 않다
gang	폭력단, 집단의, 갱단, 패거리
boiled	끓인, 삶은, 데친
so-called	소위, 이른바, 흔히 일컫는
theme	주제, 테마, 제목
thankful	감사하는, 고맙게 생각하는
admission	입학, 입장, 인정, 입원, 입국
elevated	높은, 고상한, 고가의
frenchman	프랑스인, 프랑스 선박, 유럽
pool	수영장, 풀, 모으다, 당구
terrified	무서워하는, 오싹한, 겁먹은
conference	회견, 회의, 회담, 총회, 협의
equality	평등, 동등, 공정, 균형
genus	속, 유, 종류
didst	do의 2인칭·단수·과거형
newly	새로이, 최근, 요즈음
invasion	침략, 침공, 침해, 침입
workmen	workman의 복수형
turkish	터키의, 터키어, 터키어의
discretion	결정권, 분별, 자유 재량
pattern	패턴, 무늬, 형태, 모양, 방식
reveal	보여주다, 밝히다, 드러내다, 말하다, 알리다
resolve	해결하다, 결의하다, 대책을 마련하다, 해법
preach	설교하다, 전도하다, 설법
exceeding	대단한, 과도한, 보통 아닌
ringing	울리는, 울려퍼지는, 힘차고 분명한
triumphant	의기양양한, 성공한, 승리를 거둔
defiance	도전, 반항, 무시
errand	심부름, 볼일
woke	일어났다
grandmother	할머니
wool	양모, 모직물, 울
communicate	의사소통하다, 대화하다, 전달하다, 연락하다, 통신하다
promising	유망한, 촉망되는, 전망이 좋은, 장래성 있는, 가능성이 높은
scenery	경치, 풍경, 무대
righteous	공정한, 바른, 정의의
essentially	본질적으로, 근본적으로, 기본적으로, 필히, 본래
oppose	반대하다, 저지하다, 저항하다, 대항하다, 이의를 제기하다
joyous	즐거운(joyful)
specimen	표본, 견본
eloquent	웅변의, 달변의, 설득력 있는, 감명적인
manager	매니저, 감독, 관리인, 부장, 경영자
drag	끌어내다, 계속되다, 떨어뜨리다, 장애물, 늑장부리다
haunted	사로잡힌, 불안한, 유령이 자주 나오는
chorus	합창, 코러스, 이구동성
rational	합리적인, 이성적인, 논리적인
crop	농작물, 작물, 수확, 곡물, 곡식
processing	가공, 처리
accurate	정확한, 정밀한, 올바른
wolf	늑대, 울프, 게걸스럽게 먹다, 위선자
resort	리조트, 의존하다, 휴양지, 수단
refusal	거부, 거절
bond	채권, 본드, 유대, 회사채, 결속
vicinity	인근, 주변, 가까이
preacher	설교자, 복음을 전도하는 사람, 창도자
sympathetic	동정적인, 공감하는, 호의적인
casting	주조, 주물, 배역
warmly	따뜻하게, 열렬히
salary	월급, 급여, 연봉, 임금, 보수
continuous	지속적인, 계속되는, 연속적인
satan	사탄, 악마, 마왕
continual	계속적인, 끊임없는, 빈번한
lantern	등, 랜턴
balls	balls up(~을 엉망으로 만들다)
rod	막대기, 로드, 매, 낚싯대
blaze	불, 불타다, 길을 내다, 환한, 싸우다
peculiarly	기묘하게, 별나게, 특히
ingenious	재치있는, 독창적인, 교묘한
excite	흥분시키다, 신나게 하다, 들뜨게 하다, 기대하게 만들다, 설레게 하다
horseback	말을 탄
re-use	재사용
louisiana	루이지애나, 주도 Baton Rouge. (약어)La., LA
wildly	가장, 매우, 널리, 거칠게
carpet	카펫, 양탄자, 넓은 평면
sadness	슬픔
customary	관습상의, 관례적인, 일반적인
aren't	are not의 단축형
wonderfully	잘, 훌륭하게, 놀랄 만큼
max	남자 이름, 최대한, 너무 최대한의
successor	후계자, 후임자, 후속, 후손
allied	동맹한, 공동의, 연합군
ceiling	천장, 한도, 상한, 천정, 최고 한도
confirmation	확인, 확증, 입증
goal	목표, 골, 목적
cash	현금, 돈, 현찰, 현금화하다
vacant	공석인, 비어 있는, 텅 빈, 없는
antiquity	고대, 낡음, 태고
despise	경멸하다, 멸시하다
lawn	잔디, 정원, 야외용
they'll	they will, they shall의 단축형
turkey	터키, 칠면조
neighbor	이웃, 주변 사람
ultimate	궁극적인, 최종의, 최고의, 근본적인
submission	제출, 굴복, 순종
entry	진출, 들어감, 가입, 제출, 참가
rachel	여자 이름, 살빛, 라헬
blush	얼굴이 붉어지다, 블러셔, 부끄럼을 타다
monument	기념물, 유적, 표지
hardy	튼튼한, 대담한, 무모한
thorough	철저한, 완전한, 무력 정책
ein	「~화합물」의 뜻
ecclesiastical	교회의, 성직자의, 평신도가 아닌
fertile	비옥한, 가임의, 다산의
exciting	흥미진진한, 신나는, 재미있는, 흥분시키는, 설레는
captive	감금된, 포로, 어쩔 수 없는
severity	엄격, 엄정, 격렬함
shew	show
faster	더 빨리
grandeur	위풍, 위엄, 장관
winning	우승, 해야 한다, 수상, 따다, 이긴
solely	오로지, 오직, 단지, 단독으로, 혼자서
globe	지구, 구체, 구형으로 하다
malice	악의, 원한
lodging	숙박, 숙소, 제출하다
conservative	보수적인, 보수주의자, 수수한
throng	군중
prosperous	번영하는, 성공한
whistle	휘파람, 호각
cheese	치즈, 토하다
bite	물다, 한 입, 물린 곳, 물어뜯다, 깨물다
thoughtfully	사려 깊게, 친절하게, 생각이 깊게
breach	위반, 침해, 어기다, 무너지다, 누출
enthusiastic	열정적인, 열렬한
downstairs	아래층의
invite	초대하다, 초청하다, 권하다, 부르다, 초래하다
adjoining	접해 있는, 접속해 있는, 인접한
dusk	해질녘, 황혼
cathedral	대성당, 주교좌의
plague	전염병, 괴롭히다, 페스트, 시달리다, 골치를 앓다
sandy	샌디, 모래의, 엷은 갈색의
boil	끓이다, 삶다, 비등, 졸이다, 익히다
caroline	영국 왕 찰스 1, 2세의, 여자 이름
beautifully	아름답게, 훌륭하게, 아주
inhabited	사람이 살고 있는, 주민이 있는
tomorrow	내일, 미래, 장래, 장차
exclamation	외침, 감탄, 감탄사
finishing	끝손질의, 마지막의, 마무리 공사
shocked	충격적인, 충격을 받은
escort	인도하다, 호위하다, 보호자, 의장대
mirth	환희, 명랑, 희희낙락
uncomfortable	불편한, 불쾌감을 주는, 민감한
connecticut	코네티컷, 미국 북동부의 주, (약어)Conn., Ct., CT
pierced	장식 구멍이 뚫린, 구멍이 열린, 귓불에 구멍을 뚫은
harbor	항구, 정박하다, 품다, 피난처
apparatus	장치, 기구, 기관
honesty	정직, 솔직, 양심, 청렴결백
wander	돌아다니다, 배회하다, 헤매다, 산만하다, 방랑하다
assert	주장하다, 단언하다, 강력히 주장하다
utterance	발성, 발언, 입으로 내기
dismay	실망, 당황, 경악, 유감, 놀라게 하다
fright	놀람, 두려움, 섬뜩하게 하는 사람
rail	철도, 철로, 레일, 난간
pushing	미는, 떠미는, 추진하는
jimmy	남자 이름, 짧은 쇠지레, 쇠지레로 열어젖뜨리다
pathetic	불쌍한, 한심한, 슬픈
imperfect	불완전한, 불충분한, 결함이 있는
haughty	오만한, 거만한, 건방진
navy	해군, 남색의(navy blue)
fortress	요새, 요새지, 견고한 곳
hurrying	moving with great haste
x	~에 ×표를 하다, 예, 바깥의
selling	팔리는, 판매, 매매, 셀링
appreciation	감사, 상승, 강세, 이해
suppressed	억압된, 억눌린
acquire	얻다, 인수하다, 갖다, 배우다, 구입하다
offensive	공격, 모욕적인, 불쾌한
ripe	잘 익은, 때가 된, 가능성이 높은
coldly	춥게, 차게, 냉담하게
km	kilometer, kingdom, Air Malta
sixth	6번째, 여섯 번째
blazing	타는 듯한, 불타는, 불타듯이 선명한
youngest	최연소자, 최연소의, 막내, 막내의, 가장 어린
mask	가면, 마스크, 감추다, 안대
florida	플로리다, 주도 Tallahassee. (약어)Fla., Flor
lecture	강의, 강연, 잔소리, 훈계, 설교
parlor	가게, 거실
decidedly	명백히, 명확하게, 단연
whereby	무엇에 의하여, 그리고 그것으로 인하여, 어떻게
gordon	남자 이름, 고든세터, 고든
reverend	목사, 스님, 신부, 성직자
successive	연속적인, 연달아, 계속적인, 잇단
perception	지각, 인식, 직관
buffalo	버팔로, 들소
sire	종마, 부수, 보다
develop	개발하다, 발전하다, 만들다, 키우다, 성장하다
function	기능, 역할, 작동, 작용, 행사
damned	지독하게, 놀라운, 저주받은
vexed	신경질나는, 많이 논의되는, 초조한
pouring	들이붓는, 억수로 쏟아지는
bullet	총알, 총탄, 탄환
excessive	과도한, 지나친, 엄청난, 극단적인
bind	구속되다, 묶다, 속박하다, 결합하다, 곤경
identical	동일한, 똑같은, 일란성의, 닮은
byron	바이런, 영국의 시인, 남자 이름
mexican	멕시코의, 멕시코어의, 멕시코인
piety	경건, 신앙심, 경신
superstition	미신
git	쓸모없는 놈, 바보 자식, get의 방언
substantial	상당한, 실질적인, 현저한, 중대한, 튼튼한
bulk	대부분, 대량의, 많은, 산적 화물선, 거대한
prevail	만연하다, 이기다, 팽배하다, 설득하다, 우세하다
preaching	전도, 훈계, 설교술
prolonged	연장하는, 늘리는, 장기의
annoyed	짜증난, 화가 난, 골치 아픈, 귀찮은
westminster	웨스트민스터, 영국 국회 의사당, 의회 정치
richmond	미국 Virginia주의 주도, 리치먼드, 미국 New York시의 옛 구
upset	화난, 기분 나쁜, 당황, 혼란, 아픈
cab	택시
bunch	다발, 무리, 산더미, 송이, 묶음
pencil	연필, 펜슬
vegetable	야채, 식물
exhibit	전시, 전시회, 보여주다, 설명하다
cooked	조리된, 취한
hay	건초, 헤이
kansas	캔자스, 미국 중부의 주, 캔자스 강
gale	게일, 강풍
arnold	아널드, 영국의 시인·비평가
trousers	바지
debate	토론, 논쟁, 논의, 토의, 심의
dated	날짜가 있는, 구식의, 시대에 뒤떨어진
tumult	소동, 혼란
corruption	부패, 비리, 부정, 타락
summons	소집, 호출 명령, 출두를 명하다
comrade	동지, 전우
eternity	영원, 영겁, 불멸
propriety	예의 바름, 적당, 타당
stillness	부동, 정적, 정지
partial	부분적인, 일부의, 편파적인, 불완전한
cabinet	내각, 국무, 각료, 캐비닛, 보관함
proceeds	수익금, 수입, 이익금
vow	다짐하다, 천명하다, 맹세하다, 밝히다, 단언하다
quaint	예스러운, 독특한, 별난
soup	수프, 죽
beef	쇠고기, 강화하다, 불만, 비프
slay	~을 죽이다, 살해하다, sley(베틀의 바디)
surgeon	외과의사, 군의관
irresistible	저항할 수 없는, 억누를 수 없는, 압도적인
sealed	밀봉된, 봉인을 한, 포장된
repeating	반복의, 연발식의, 반복하는
needn't	need not의 단축형
allowance	용돈, 수당, 비용, 허용, 할당량
treachery	배반, 믿을 수 없는
borders	보더스 주
attendant	승무원, 종업원, 참석자, 수행원
unite	통합하다, 단결하다, 통일하다, 결혼하다
murderer	살인자, 살해자
nm	New Mexico, night message, no mark
sweeping	광범위한, 휩쓰는, 압도적인, 쓸다, 쓰다듬다
unconsciously	부지불식간에, 무의식적으로
blade	날, 블레이드, 칼날, 다리, 날개
graham	남자 이름
behaved	행동하는, ~한 태도의
spy	스파이, 간첩, 첩보, 감시하다, 염탐하다
lawful	합법적인
tommy	말괄량이, 남자 이름, Tommy Atkins
withdrawn	withdraw의 과거 분사형, 고립한, 세상과 등진
reckless	무모한, 무분별한, 부주의한
factory	공장, 회사, 제조소, 팩토리
gossip	소문, 수다, 가십, 험담, 뒷말
seventh	7번째, 일곱 번째
attendance	참석, 출석, 관객, 돌봄
journal	정기 간행물, 저널, 일기, 잡지
dryden	드라이든
maine	메인, 미국 북동부 대서양안의 주, 메인호
token	표시, 교환권, 토큰
intimacy	친밀, 친교, 친함
abstract	추상적인, 요약하다, 초록
bestow	수여하다, 주다, 쓰다
honestly	솔직하게, 정말, 정직하게, 사실
legitimate	합법의, 정당한, 정통의
accent	억양, 악센트, 사투리, 말투, 두드러지다
ragged	너덜너덜한, 누더기의
thursday	목요일
fidelity	충실도, 엄수, 충성
swinging	활동적이고 현대적인, 기운찬, 프리섹스를 즐기는
descending	하강하는, 하락하는, 아래로 향하는
sincerely	진심으로, 진정으로, 성실히, 진지하게, 정말로
bred	~하게 자란, breed의 과거·과거 분사형
whereof	무엇의, 무엇에 관한, 누구의
indies	서인도 제도, 인도 아대륙, 인도 제국
league	리그, 연맹, 부류, 대회
failing	결점, 실패, 낙제
succeeding	이어서 일어나는, 다음의, 계속되는
santa	성녀, 산타클로스(Santa Claus), 성~
approve	승인하다, 찬성하다, 동의하다, 허가하다, 인정하다
cautiously	조심하여, 신중히
miller	제분업자, 미국 극작가, 미국 맥주
afflicted	괴로워하는, 고통받는, 고민하는
petition	청원, 탄원, 호소, 소원, 신청
traffic	교통, 차, 통행, 트래픽, 거래
sparkling	발포성의, 불꽃을 내는, 활기에 넘친
limb	팔다리, 의족, 가지
architecture	건축, 설계, 아키텍처
disposal	처리, 처분, 폐기
crack	균열, 금 가다, 갈라지다
kindred	동류의, 일족, 혈연
naught	제로, 영, 무
ornament	장식
slew	많음, 다량, slay의 과거형
steward	집사, 승객 담당자, 승무원
fantastic	환상적인, 멋진, 이유없는, 상상의, 이상한
evolution	진화, 변화
patiently	끈기 있게, 침착하게
reverse	반대의, 뒤집다, 바꾸다, 파기하다, 되돌리다
survey	조사하다, 연구하다, 평가하다
dug	dig의 과거·과거 분사형, 젖꼭지, 젓통
amuse	재미있게 하다, 즐겁게 하다, 관심을 두다, 놀라게 하다
stretching	스트레칭
isaac	남자 이름, 이삭
forthwith	곧, 즉시, 지체 없이
contemporary	현대의, 동시대의, 최신의, 동년배의
foliage	잎, 전체 잎, 나뭇잎
scandal	사건, 스캔들, 추문, 불명예, 물의
deliberate	심의하다, 고의적인, 심사숙고하다, 신중한
intolerable	참을 수 없는, 견딜 수 없는, 지나친
hearth	노변, 노상, 가정
symbol	상징, 기호, 모양, 심볼
pleasantly	즐겁게, 기쁘게, 기분 좋게
homage	존경, 경의, ~에게 경의를 표하다
victorious	승리의, 우승의, 이긴
recovery	회복, 복구, 회수, 재생
defined	정의된
modesty	겸손, 정숙함, 소박함
washing	씻기, 세탁, 떠밀려 오다
pavement	포장 도로, 인도
unnatural	부자연스러운, 비정상적인, 극도로 잔혹한
decisive	결정적인, 단호한
wisely	현명하게, 지혜롭게, 효율적으로
precise	정확한, 정밀한
negative	부정의, 마이너스의, 반대의, 음성의, 비판적인
occurrence	사건, 발생, 일어난 일
shaft	샤프트, 굴대, 통로
linked	연관된, 연쇄된, 연계된
festival	축제, 페스티벌, 행사, ~제
exclusively	독점적으로, ~만을 위한, 전용의, 전적으로
wickedness	사악함, 심술궂음, 장난스러움
maggie	여자 이름, magpie, 매기
rosy	장밋빛의, 낙관적인
carelessly	부주의하게, 경솔하게
stem	줄기, 생기다, 막다, 뿌리, 다리
corporation	기업, 회사, 법인
feeding	급식, 사육, 음식을 섭취하는
preference	선호, 좋아하기, 특혜, 우선권, 편애
urge	촉구하다, 요구하다, 해야 한다, 강조하다, 주장하다
shrill	날카로운
sovereignty	주권, 영유권, 통치권
reduce	줄이다, 감소시키다, 줄어들다, 축소하다, 낮추다
distressed	고민하고 있는, 곤궁에 처해 있는, 투매 의
clearing	정리하다, 청산, 제거, 맑다, 목을 가다듬다
removal	제거, 철거, 파면, 철수
dean	학장, 원장, 처장
assertion	주장, 단언, 자기 주장
accessible	접근할 수 있는, 이용 가능한, 사용하기 쉬운
comedy	코미디, 희극
flush	물을 내리다, 붉어지다, 내보내다
code	규정, 코드, 암호, 번호
adequate	적당한, 충분한, 부족하지않은
vaguely	막연히, 어렴풋이, 애매하게
treason	반역죄, 배신
hunter	사냥꾼, 헌터, 추구하는 사람
split	나누다, 분열시키다, 쪼개다, 헤어지다, 분담하다
yielding	양보를 잘 하는, 잘 구부러지는, 수확이 많은
newsletter	회보, 연보, 사보
snake	뱀
historian	역사가, 사학자
ass	걷어 차다, 골칫거리, 엉덩이, 아첨하다, 노력하다
intensity	강도, 강렬함, 중요성, 집중
democracy	민주주의, 민주적
battery	배터리, 건전지
creed	신조, 주의, 신념
liking	좋아함, 애호
tyrant	독재자, 폭군
strove	strive의 과거형
attraction	명소, 매력, 인기물, 끌림
slaughter	도살하다, 학살하다, 도살
dismal	암울한, 형편없는, 부진한
assent	동의, 동의하다, 찬성
concert	콘서트, 공연, 음악회, 연주회, 협주곡
downward	내려가는, 하향의, 이후의
canal	운하, 체내의 관
evenings	저녁에는 꼭, 저녁마다, 저녁에는
wax	밀랍, 왁스, 차다, 음반, 귀지
detective	형사, 탐정, 수사관
spoiled	버릇없이 자란
revolver	회전식 연발 권총, 리볼버, 회전 장치
analysis	분석, 해석
roaring	으르렁거림, 노호하는, 몹시
prompt	신속한, 촉발하다, 촉구하다
paperwork	기록·서류의 정리·보존 등의 일, 사무, 사무 처리
wherefore	원인, 무엇을 위하여, 그런 까닭에
emphasis	강조, 중점, 중요, 중시, 주안점
sharing	서로 나누어 가지기
inherited	상속한, 계승한, 유전의
bronze	동, 청동, 동상, 브론즈
waking	깨어 있는, 일어나 있는
garment	의류, 옷
wholesome	건강에 좋은, 대규모의, 신중한
remorse	후회, 가책, 반성, 회환, 참회
dew	이슬, 물방울
monk	수도사, 수도승, 수사
thrill	흥분, 스릴, 오싹함
hue	색조, 경향
exclusive	배타적인, 독점적인, 유일한
porter	짐꾼
uncommon	흔치않은, 이상한
dash	돌진하다, 찬물을 끼얹다, 빠르게 쓰다, 활기찬, 서두르다
strained	피곤한, 긴박한, 긴장된
confounded	당황한, 괘씸한, 지독한
swim	수영하다, 헤엄치다, 뜨다, 젖다, 대세
strip	박탈하다, 스트립, 빼앗다, 벗기다, 없애다
ultimately	마침내, 결국, 최후로
team	팀, 부
missionary	선교의, 전도의
esteemed	존경받고 있는, 높이 평가되고 있는
envelope	봉투
whoever	누구나
expensive	비싼, 돈이 많이 드는, 고가의, 많은 비용, 사치스러운
headquarters	본부, 사령부, 청사
cherished	소중하게 간직한, 중요하게 지켜져 온
brandy	브랜디
startling	깜짝 놀라게 하는, 놀랄만한, 놀라운
homer	홈런을 치다, 전서구, 고대 그리스의 시인
acute	심각한, 급성의, 예리한, 절실한, 확실히
cigarette	담배, 궐련
motor	자동차, 모터, 운동의
embarrassed	당황한, 부끄러운, 당혹스러운
volunteer	봉사하다, 자원하다, 지원하다, 자발적인, 참가자
offspring	자식, 새끼
network	네트워크, 통신망, 망, 관계, 연계
indispensable	필수적인, 불가결한, 꼭 필요한
plane	비행기, 날개, 면, 평면, 대패
reaction	반응, 반발, 반작용
g	영어 알파벳의 일곱째 자
partially	부분적으로, 일부
proudly	자랑스럽게, 당당하게
baggage	짐, 수화물, 가방
terrace	테라스
deaf	청각 장애의, 들으려고 하지 않는
allusion	암시, 언급, 넌지시 말함
grip	단단히 잡음, 손잡이, 지배력
juice	주스, 즙, 힘
resigned	순종하는, 묵묵히 따르는, 퇴직한
humility	겸손
benjamin	남자 이름, 벤자민, 막내둥이, 100달러짜리 지폐
blast	폭발, 발사하다, 공격하다, 날리다, 홈런을 치다
ministry	정부의 부서, 장관의 직무, 목사의 직무
sexual	성적인, 성행위의, 생식의
diameter	지름, 직경
troop	군대, ~군, 파병, 병력, 부대
onward	~에서부터, 앞으로
marrying	결혼하는, 결혼할
tightly	꼭, 엄격히, 단단히, 잘
sullen	부루퉁한, 삐친
brutal	잔인한, 무자비한, 야만적인, 폭력적인
axe	도끼
penalty	처벌, 벌금, 페널티, 불이익
tops	최고인, 최고로, 일류의 사람
diamond	다이아몬드, 야구장
boards	the stage of a theater
corridor	복도
alternate	번갈아 하다, 대체하다, 교류하다, 교차하다, 교대의
echo	반영하다, 메아리, 맥을 같이하다, 공감하다, 되풀이
restraint	자제, 제한, 규제
identity	신원, 동일성, 정체
headed	이끌다, 갔다, 향했다, 앞두다, 치닫다
quivering	떨리는, 진동하는, 떨고 있는
sway	흔들다, 영향을 주다, 동요하다, 움직이다, 영향력
poetical	시적인, 이상화된, 시로 쓰여진
screen	화면, 영화, 스크린, 상영관, 심사하다
professed	공언한, 공공연한, 전문의
dirt	먼지, 흙, 때, 스캔들, 소문
era	시대, 시절, 방어율
ambassador	대사, 대표, 사절
breed	품종, 번식하다, 사육하다
interference	간섭, 방해, 혼선
afar	멀리서, 멀리에, 멀리
consist	이루어지다, 구성되다
acceptance	받아들임, 수락, 수용, 합격 통지, 인정
flashing	번쩍번쩍 빛나는, 점멸하는, 구매 물받이
hunted	쫓긴, 사냥꾼에게 몰린, 겁에 질린 듯한
lazy	게으른, 나태한, 나른한
shrewd	약삭빠른, 빈틈없는, 영리한, 현명한, 능수능란한
extravagant	낭비하는, 사치스러운, 터무니없는
momentary	순간의
cordial	따뜻한, 정중한, 진심의
engineer	기술자, 엔지니어, 공학자, 공병, 운영하다
rapidity	빠르기, 급속, 민첩
nov	novelist, November
halt	중단, 막다, 중지하다, 멈추다, 마비
alternative	대안, 대체, 대신의, 다른, 얼터너티브
stamp	우표, 도장, 찍다, 인지, 짓밟다
compact	소형의, 아주 작은, 콤팩트, 조밀한, 맹약
breathless	숨이 가쁜, 죽은, 바람 한 점 없는
encoding	부호화
drift	떠다니다, 멀어지다, 이동, 빈둥대다
disappear	사라지다, 없어지다, 실종되다, 자취를 감추다, 소멸되다
counter	반대의, 카운터, 계산대, 창구, 조리대
venus	비너스, 금성, 로마 신화의 사랑과 미의 여신
imaginary	상상의, 가상의, 가식적인
diminished	감소된, 권위가 떨어진, 반음 낮춘
ray	빛, 가오리, 광선
climbing	등산, 등반, 상승, 기어오름
attract	끌다, 유치하다, 유혹하다, 유인하다
astonishing	놀라운, 상당한
competition	경쟁, 대회, 경기, 시합, 경합
ink	잉크, 서명하다, 먹물
oft	Office of Fair Trading,orbital flight test(궤도 비행 테스트), often, 흔히, 종종
crystal	크리스털, 결정체, 수정, 맑은, 명확한
shower	샤워, 샤워기, 소나기, 쏟아지다
ferdinand	페르디난트
obedient	순종하는, 공손한, 얌전한
draught	외풍
wondrous	놀라운, 놀랍게, 경이로운
await	기다리고 있다, 기대하다
armour	갑옷, 장갑
massive	대규모의, 거대한, 막대한, 대대적인, 강력한
kin	친척, 민족, 동일 종족
cellar	지하실, 저장실
falsehood	거짓말, 허언, 기만
edgar	남자 이름, 에드거 상, 에드거
philosophical	철학의, 달관한 듯한
martha	여자 이름, 마르타
memorable	기억할 만한, 인상적인, 중요한
stealing	장물, 훔치는, 몰래 훔치기
noisy	시끄러운, 떠드는, 요란한, 떠들썩한
henceforth	지금부터는, 앞으로, 차후
cicero	키케로, 고대 로마의 정치가
laden	실은, 지고 있는, 짐을 실은
frost	서리, 프로스트, 얼어붙다, 결빙, 추위
device	장치, 기기, 기구, 고안, 폭발물
glare	확연한, 심한, 노려보다, 눈부신 빛, 번쩍이는 빛
senate	상원, 의회, 원로원
lasting	지속되는, 영구적인, 내구력이 있는, 오랜, 영원한
communion	영적 교감, 공유, 공유 상태
transport	운송하다, 교통, 이동하다
constantinople	콘스탄티노플, Istanbul의 구칭
coffin	관
eventually	결국, 최종적으로, 마침내, 언젠가는
johnny	녀석, 놈, 짧은 가운
enclosed	일반인은 들어갈 수 없는, 금지 구역의, 외계와의 접촉이 없는
forgiveness	용서, 탕감, 면제
awfully	아주, 상당히, 너무
clinging	몸에 꼭 맞는, 점착성의, 남에게 의존하는
contemplation	응시, 명상, 정관
manufacture	제조, 생산, 산업, 제품, 꾸며내다
swallow	삼키다, 제비, 감수하다
commonplace	흔한, 다반사, 주변에 널린, 주로 ~하는
nancy	여자 이름, 여자 같은 남자, 남성 동성애자
she'd	she had, she would의 단축형
contracted	찌푸린, 수축된, 수죽한
inscription	비문, 비명, 적힌 것, 내접
comfortably	편안하게, 편리하게, 수월하게
indulge	빠지다, 탐닉하다, 제멋대로 하게 하다, 이용하다, 만족시키다
indulgence	탐닉, 방종, 욕망의 만족
bravely	용감하게, 훌륭하게
yea	예, 그렇다, 찬성 투표
keenly	날카롭게, 강렬하게, 예민하게
exhibition	전시, 작품, 박람회, 시범, 공연
agricultural	농업의, 농예의, 농학의
enlightened	계발된, 잘 알고 있는, 정통한
quest	추구, 탐구, 원정
crest	벼슬
extension	연장, 내선번호, 확대, 확장, 연기
uneasiness	불안, 걱정, 불쾌
constitute	구성하다, 간주하다, ~에 해당하다, 제정하다, 나타내다
swing	스윙, 휘두르다, 그네, 흔들다, 여행
meadow	초원, 목초지
downloading	다운로드, 내려 받기
complex	복잡한, 단지, 복합의, 종합의, 콤플렉스
controversy	논란, 논쟁, 문제, 갈등, 의혹
resignation	사퇴, 사임, 사표, 체념
tempest	폭풍우, ~을 격렬히 휩쓸다, 대소동
guidance	지도, 지침, 인도
humbly	겸허하게, 송구스럽게, 황송스럽게
lined	선을 그은, 안을 댄, 주름이 있는
serene	고요한, 조용한, 맑게 갠
roughly	대략, 거의, 거칠게
remarkably	현저하게, 두드러지게, 눈에 띄게
dainty	맛있는 것, 우아한, 화사한
overhead	간접의, 위에, 상공의
commencement	졸업, 시작
singularly	대단히, 두드러지게, 각별히
brightness	광도, 밝음, 빛, 영리함
oppression	탄압, 억압
repeatedly	반복적으로, 거듭해서, 여러 차례, 되풀이하여, 번번이
conspiracy	음모, 공모, 공동 모의
restrain	제한하다, 자제하다, 금지하다, 검거하다, 압박하다
splendor	영광, 장관
preservation	보존, 보호, 보전
pub	술집, 펍, 호프집
pepper	후추, 고추, 페퍼, 피망, 퍼붓다
basin	분지, 유역, 대야
creeping	포복, 천천히 나아가는, 몰래 다가가는
publicly	공개적으로, 공식적으로, 공공연하게, 공적으로
continuing	갱신할 필요가 없는, 연속된, 계속적인
grove	작은 숲
calamity	재난, 불행, 참화
pony	조랑말, 포니
vigour	forceful exertion
melody	멜로디, 곡조, 선율
profitable	수익성이 좋은, 이익이 되는, 이윤을 내는, 돈벌이가 되는, 도움이 되는
hire	고용하다, 채용하다, 뽑다, 사람을 쓰다, 빌리다
speculation	투기, 추측, 의견, 사색
drunken	술 취한, 취중의
candidate	후보자, 지원자, 수험생
principally	주로
worried	걱정되는, 우려되는, 두려운
obstinate	완고한, 고집센, 고치기 힘든
hasten	서두르다, 서둘러, 촉진하다, 재촉하다
elderly	노인층, 나이든, 중장년층, 어른, 노후
telegraph	전신, 전보, 전신기
university	대학교
ghastly	무시무시한, 지독한, 무섭게
patron	후원자, 고객, 경영자
varying	가지각색의, 바뀌는 변화하는, 바뀌는
barbarous	야만스런, 잔혹한, 미개한
celestial	하늘의, 천인, 천체의
t'	the, to
patriotism	애국심, 애국, 애국적 행위
modify	변경하다, 변형하다, 조절하다
earnestness	진지함, 진정, 성실
exertion	노력, 진력, 행사
fox	여우, 폭스, 매력적인
inspection	감사, 조사, 검사, 점검, 검열
grieved	슬퍼하는, 비탄에 잠긴, 슬픈
bursting	넘칠 듯한, 가득찬, 안달이 난
mournful	애도하는
traitor	반역자, 배신자, 매국노
cautious	신중한, 조심스러운, 주의를 기울이는
prior	전의, 앞서, 직전의, 기존의, 이제까지
undertook	undertake의 과거형
telegram	전보, 전신
beggar	거지, 가난하게 만들다, 걸인
chimney	굴뚝
complicated	복잡한, 어려운, 난해한
converse	대화하다, 이야기하다, 반대
wiped	취한, 지친, 파산한
apology	사과, 사죄, 변명
scared	무서운, 겁먹은, 두려워하는, 놀란, 공포에 떠는
imprisonment	투옥, 감금, 구속
eastward	동쪽, 동쪽을 향하여
substitute	대체하다, 대신, 대용하다, 대리, 대행
handful	소수, 몇~, 한 줌, 감당하기 어려운
usage	사용, 용법, 소비, 용도
of.	없어져, 떨어져, 쉬어, 벗어나, 떠나다
villain	악당, 악한, 악역
restoration	복원, 복구, 회복, 왕정 복고, 반환
serpent	뱀, 악마, 사탄
hedge	헤지, 대비책, 회피하다, 분산하다
k	영어 알파벳의 열한째 자
jurisdiction	사법권, 관할권, 권한
valiant	용감한, 씩씩한, 단호한
primary	주요한, 초등학교의, 주된, 예비의, 기본적인
beam	광선, 빔, 광선을 발사하다, 방송하다, 미소짓다
victoria	빅토리아, 여자 이름, 빅토리아 여왕
tour	투어, 관광, 일주, 여행, 순회공연
prophecy	예언, 예언 능력, 신의의 전달
spectacles	안경눈무늬
obsolete	시대에 뒤진, 구식의, 쓸모없게 된
shepherd	셰퍼드, 양치기, 목자
wells	웰스, 영국 잉글랜드 남서부 서머셋주의 도시
exaggerated	과장된, 과대한, 크게 떠벌리는
heated	가열된, 격렬한, 흥분한
earl	얼, 백작
hereditary	세습의, 유전의, 유전하는
supernatural	불가사의한, 초자연의, 이상한
competent	유능한, 능력이 있는, 만족스러운
piled	보풀이 있는, 타올천으로 된, 보풀 있는
hostess	여주인, 여종업원, 호스티스, 여성 사회자
agriculture	농업, 축산
urgent	긴급한, 긴박한, 다급한, 급박한, 절박한
gratified	만족하고 있는, 만족한, 기뻐하는
suffice	충분하다, 말해 두다
accuracy	정확, 정확도, 면밀
deceased	사망한, 죽은, 고인
circular	원형의, 순환하는, 광고 전단
alert	경계, 주의하다, 집중하다, 알림, 기민한
neighboring	근처에 사는, 인근의, 접하고있는
democratic	민주당의, 민주적인, 민주주의의
bud	시작되는, 싹, 봉오리
augustus	남자 이름, 아우구스투스
blanket	담요, 뒤덮다, 흥을 깨는, 전면적인, 층(層)
hail	출신, 환영하다, 찬양, 인정받다, 부르다
pretence	가식, 핑계, 주장
pig	돼지
shaped	모양이 ~인, ~형의, 모양 지어진
oven	솥, 오븐, 화덕
rounded	둥글게 된, 완성된, 세련된
ivory	상아, 아이보리
northward	북쪽으로
isolated	고립된, 절연된, 격리된
policeman	경찰관, 경관, 순경, 전경
conventional	전통적인, 틀에 박힌, 관습의
babylon	바빌론, 사치와 죄악의 도시, 유형지
dusty	먼지투성이의, 칙칙한
plead	애원하다, 주장하다, 호소하다, 간청하다, 항변하다
hinder	방해하다, 저해하다, 막다
cord	줄, 코드, 척수
personage	명사, 유력자, 사회적 지위가 높은 사람
classical	클래식의, 클래식 음악의, 고전의, 전통적인, 고전 문학의
alongside	함께, 옆에, 나란히, ~와 같은, 비롯하여
extract	추출하다, 이끌어 내다, 채굴하다, 뽑아 내다, 농축액
lighter	거룻배, 점등기, 거룻배로 나르다
pint	파인트, 잔
sternly	엄격히, 엄격하게, 엄하게
proclamation	선언, 선포, 공표, 성명
pitched	경사진, 비탈진, 특정 장소에 떨어지게 던진
tube	튜브, 관, 텔레비전, 터널, 빨대
observer	관측자, 전문가, 옵서버, 입회인, 감시자
smote	smite의 과거형
avenue	~가, 길, 방법
elephant	코끼리
burke	묵살하다, ~을 질식사 시키다
footing	기초, 기반, 입회
statesman	정치가, 정치인
doomed	운이 다한, 불운한
esther	에스더, 여자 이름
indiana	인디애나, 주도 Indianapolis. (약어)Ind., IN
affecting	감동시키는, 감격적인, 감동적인
stormy	폭풍의, 격렬한, 비바람의
bee	벌
bury	묻다, 묻히다, 매장하다, 가리다
efficient	효율적인, 효과적, 유능한, 능률적인
mix	섞다, 혼합하다, 혼혈, 결합하다, 믹스
supporting	받치는, 원조하는, 조연하는
actor	배우, 남우, 행위자
disturbance	소란, 방해, 장애, 불안, 타격
sweat	땀을 흘리다, 스웨트, 걱정하다, 초조하다
executive	임원, 대표, 경영자, 책임자, 행정부의
seemingly	겉보기에는, 언뜻 보기에, 보기에
tenth	제10의, 십분의 일
ethel	여자 이름, 연약한 남자
painfully	괴로운 듯이, 가슴 아프게, 매우
polish	광택, 다듬다, 닦다, 폴란드의, 세련되다
shudder	떨다, 몸서리치다, 전율
comparative	비교의, 상대적인, 상당한
begging	걸식 생활, 걸인의, 구걸
imposing	웅장한, 인상적인, 눈을 끄는
notable	주목할 만한, 유명한, 두드러진, 뛰어난
mute	무언의, 약음기, 소음기
amy	여자 이름
cage	우리, 케이지, 새장 모양의
esq	~ 귀하, ~ 님, 지방의 명사
cargo	화물, 짐
jail	감옥, 징역, 수감, 투옥, 교도소
skilful	솜씨 좋은, 교묘한
illusion	착각, 환상
torment	괴롭히다, 고통
troublesome	말썽부리는, 문제를 일으키는, 귀찮은, 힘든
feb	February
repentance	후회, 양심의 가책, 참회
proprietor	소유자, 소유주, 소유경영인
uncertainty	반신반의, 불확실, 확신이 없음
concentrated	집중된, 밀집한, 농축된
mediterranean	지중해의
scream	비명, 절규, 소리치다, 환호
compromise	타협하다, 절충하다, 손상시키다, 양보하다, 노출시키다
respectful	존경하는, 예의바른
chariot	~을 전차로 나르다, 1인승 이륜 전차, 전차
ammunition	탄약, 무기, 명분
bonnet	보닛, ~에 모자를 씌우다, 테 없는 모자
secondary	중등 교육의, 중등 학교의, 부차적인, 두 번째의
persia	페르시아 제국, 페르시아
persecution	박해, 학대, 귀찮게 괴롭힘
lesser	덜한, 부족한, 작은, 적은
assistant	조수, 보조, 비서, 보좌의
springing	spring하는 운동, spring, springing line
cane	지팡이, 설탕수수, 막대기, 케인
fold	~배, 접다, 쇠약해지다, 개다, 끼다
boundary	경계, 영역, 한계, 테두리
valued	가치를 가진, 높이 평가되는, 존중되는
she'll	she will, she shall의 단축형
rugged	험악한, 튼튼한, 거친
aloft	위에, 높이, 높은 곳에
thieves	thief의 복수형
parlour	가게, 거실
indebted	부채가 있는, 은혜를 입은, 신세진
tons	꽤, 상당히, 제법
dave	남자 이름
moore	남자 이름, 무어, George, ; Esther Waters, The Book Kerith
argue	주장하다, 논쟁하다, 논의하다, 말다툼하다, 왈가왈부하다
dearly	끔찍이, 몹시, 큰 희생을 치르는
logic	논리, 생각
panic	공황, 공포, 패닉, 당황, 두려워하다
restrained	삼가는, 자제된, 억제된
lb	파운드
vainly	헛되이, 자만하여, 공연히
weariness	피로, 싫증, 지루함
franklin	남자 이름
rural	시골의, 농업의, 지방의, 전원의
torrent	폭발, 급류, 토렌트
resolute	단호한, 결의에 찬, 의지가 굳은
refrain	자제하다, 삼가다, 후렴
gorgeous	멋진, 예쁜, 우아한, 화려한
circulation	유통, 발행 부수, 순환, 통화, 대중적인
passionately	격렬하게, 격노하여, 열렬하게
unexpectedly	예상외로, 갑자기
stress	스트레스, 강조하다, 압박, 중점을 두다
consumption	소비량, 소비, 폐결핵
groan	신음하다, 괴로워하다, 불평하다
sustain	지속하다, 부상을 입다, 지탱하다, 견디다, 지지하다
crash	충돌하다, 추락하다, 고장나다, 붕괴하다, 폭락
resemble	~와 닮은, 유사하다
epoch	신기원, 시대
quote	인용하다, 견적하다
lacking	부족한, ~이 없는, 결여된, ~을 못하는
nominally	명목상, 이름으로, 지명하여
choked	막힌, 숨막히는, 메인
aristocracy	귀족 정치, 귀족, 귀족 사회
granite	화강암, 구들장, 대리석
gradual	점진적인, 조금씩
joyful	즐거운
sack	해고, 자루, 퇴출, 약탈하다, 봉지
slumber	선잠, 잠, 잠자다
detached	초연한, 분리된, 공정한
shadowy	어두운, 그림자 같은
accompanying	부수하는, 동봉의, 첨부의
annoyance	성가심, 짜증
crush	반하다, 눌러부수기, 홀딱 반함, 으깨다, 부서지다
needle	바늘, 주사, 침
repent	뉘우치다, 후회하다
phenomenon	현상, 장관
execute	처형하다, 집행하다, 만들어내다, 발효시키다
canst	can의 2인칭·단수·현재형
smoked	훈제의, 훈제한, 그을린
greet	인사하다, 맞이하다, 환영하다, 받다, 만나다
monarchy	군주제, 왕조
behave	행동하다, 처신하다, 작용하다
richly	부유하게, 부자로, 풍부하게
controlled	통제당한, 지배, 조종, 제어, 관리된
strive	노력하다, 애쓰다, 분투하다, 싸우다
endeavor	노력, 시도, 실시
barrier	장벽, 장애물, 장애
canadian	캐나다의, 캐나다 사람
curve	곡선, 커브, 굽은, 구부리다, 상대 평가
politeness	예의, 공손함, 정중함
flora	식물상, 식물구계, 식물지
rely	의존하다, 의지하다, 믿다, 신뢰하다
flank	측면, 옆구리, ~의 측면을 우회하다
convenience	편리, 편의
courteous	예의 바른, 정중한, 친절한
lamb	새끼양, 양고기, 어린 양, 램
effectually	효과적으로, 적절히
robinson	로빈슨
logical	논리적인, 타당한, 필연적인
shan't	shall not의 단축형
dimly	희미하게, 어슴푸레하게, 어스레하게
withered	시든, 말라빠진, 쇠약해진
diet	다이어트, 식단, 음식, 식생활, 식이 요법
mantle	맨틀, 외벽, 망토
chicken	닭, 치킨, 닭고기, 병아리, 겁쟁이
judicial	사법의, 재판의, 재판상의
consistent	일관된, 지속적인, 일치하는, 일리가 있는
ridicule	조롱하다, 놀리다
as.	묻다, 요청하다, 질문하다, 부탁하다, 말씀하다
reins	신장, 감정과 애정, 신장 근방
barrel	배럴, 통, 북, 총신
distrust	~을 신뢰하지 않다, 불신, 의혹
verily	정말로, 참으로, 진실로
feather	깃털, 가벼운 것
desperately	필사적으로, 절실하게, ~하고 싶은, 반드시, 절망적으로
goodly	고급의, 값진, 아름다운
habitual	상습적인, 습관적인, 평소의
voluntary	자발적인, 자원 봉사의, 저절로
luncheon	오찬, 점심
eighteenth	열여덟 번째의, 1/18
expert	전문가, 숙련된, 달인
coolly	서늘하게, 냉정하게, 냉담하게
tedious	지루한, 장황한
clark	남자 이름, 클라크
jacket	재킷, 상의, 조끼, 표지
shrank	shrink의 과거형
swimming	수영
kent	켄트, 영국 잉글랜드 남동부의 주, 남자 이름
perplexed	어찌할 바를 모르는, 당혹한, 복잡한
impressive	인상적인, 놀라운, 눈부신, 감동적인
universally	도처에, 널리, 널리 보편화하여
displeasure	불만, 화남, 불쾌
underneath	아래의, 저변의
expedient	편리한, 방편, 수단
emma	여자 이름, 무선에서 문자 m을 나타내는 통신 용어
impress	인상, 감동시키다, 감명을 주다
bounded	경계가 있는, 구획된, 유계의
provincial	지방의, 도의, 시골의
popularity	인기, 인지도
baker	제빵업자
shattered	산산이 부서진, 손상된, 결딴난
merciful	자비로운
olive	올리브
tramp	떠돌이, 짓밟다, 걷다, 방종한 여자
compensation	보상, 보상금, 배상, 보수, 급여
ernest	남자 이름
martial	전쟁의, 호전적인, 무용의
genial	친절한, 온화한, 따뜻한
syria	시리아
conjecture	추측하다, 추측, 억측
van	전위, 키, 선광 삽
waiter	웨이터, 종업원
promote	홍보하다, 촉진하다, 증진하다, 승진하다, 조장하다
delaware	델라웨어, 주도 Dover. (약어)Del, DE, 델라웨어족의
covenant	계약, 서약, 계약하다
nought	제로, 영, 무
seizing	점유, 압류, 체포
sinner	죄인, 나쁜 사람, 장난꾸러기
vigor	활력, 활기, 박력, 용기
devote	헌신하다, 바치다, 전념하다, 쏟다, 몰두하다
decorated	장식된, 훈장을 받은, 장식식의
sentimental	감상적인
yoke	멍에, 결합하다, 지배
warlike	호전적인, 도전적인, 군사의
perilous	위험한
hostility	적개심, 적대, 전쟁, 반대
dragging	매우 지친, 느릿느릿한, 드래그 레이스를 하는 일
mare	암말
obstacle	장애, 방해, 장애물
sage	현명한, 슬기로운, 현자
destitute	빈곤한, 가난한, 결핍한
sleepy	졸리는, 잠이 오는, 조용한
dublin	더블린, 아일랜드 공화국 및 Dublin주 수도, 아일랜드 동부의 주
jonathan	요나단, 미국 정부, 전형적인 미국인
posterity	후세, 후손
they'd	they had, they would의 단축형
nod	끄덕이다, 목례하다
mason	석공
patriotic	애국적인
plantation	농장, 재배장, 조림지
pitiful	불쌍한, 비참한, 비열한
foster	육성하다, 증진하다, 만들다, 입양, 포스터
requisite	필수의, 필요한, 필요 조건
expose	노출하다, 폭로하다, 드러내다, 보이다, 밝히다
oxen	ox의 복수형
patch	패치, 조각, 지역, 수습하다, 헝겊 조각을 대다
anderson	앤더슨 강, 앤더슨
stuart	남자 이름
interruption	중단, 방해, 장애
lance	창, 창기병, ~을 창으로 찌르다
payable	지급해야 할, 지급 만기인, 지급 가능한
definition	정의, 의미, 개념
birthday	생일, 탄생, 생신, 창립기념일
thumb	엄지, 훑어보다
wolves	wolf의 복수형
hammer	망치, 해머, 두드리다
overwhelming	압도적인, 굉장한, 너무도, 견디기 어려운
intensely	격렬히, 강렬하게, 열심히
revolutionary	혁명의, 혁신적인
fragrant	향기로운, 달콤한
bleeding	출혈, 출혈하는, 사혈
sheltered	보호된, 지켜진, 세상의 모진 풍파에서 격리된
circuit	회로, 서킷, ~계, 순회
sales	판매량, 매출, 영업, 수출, 소비
energetic	힘이 넘치는, 활기찬, 활동적인, 정력적인
insignificant	미미한, 중요하지 않은
repetition	반복, 되풀이, 중복
we'd	we had의 단축형
amazing	놀라운, 멋진, 대단한, 흥미로운
tip	정보, 비결, 힌트
trivial	사소한, 하찮은
kick	차다, 발길질, 킥, 끊다, 쏘는 맛
rejoicing	기쁨, 환희, 환호
dig	파다, 발굴하다, 캐내다, 섞다
pet	애완동물, 펫
skull	두개골, 해골, 머리뼈, 유골, 스컬
ness	「성질」 「상태」를 뜻하는 추상 명사를 만듦, 네스 호, 곶
threat	위협, 우려, 조짐
legislature	의회의, 입법부의, 의원의
plunder	약탈하다, 약탈, 강탈
removing	이전, 제거
jungle	정글, 밀림
famine	기근, 기아, 굶주림
sorrowful	비탄에 잠긴, 비통한, 슬픔
coleridge	콜리지
fuller	둥근홈을 내다
shrine	성지, 사당, 신전, 제단, 성당
heel	힐, 뒤꿈치, 발, 끝부분, 따라오다
typical	전형적인, 일반적인, 평범한, 특유한
fortunately	다행히, 운좋게
fuel	연료, 부채질하다
tranquil	고요한, 조용한
frown	눈살을 찌푸리다, 난색을 표하다, 못마땅한
destination	목적지, 목표, 종착지, 도착지, 행선지
plunge	감소하다, 떨어지다, 급락하다, 추락하다, 뛰어들다
moor	황야, 정박하다, 무어인
pin	핀, 비밀 번호, 걸다, 못바늘, 압정
mars	화성, 마르스
associate	관련시키다, 연관, 동료, 부, 어울리다
here's	here is의 단축형
owen	남자 이름, 오언
arabic	아랍어
vicious	악순환, 사악한, 잔인한, 부도덕한
framed	틀에 넣은, 테두리를 두른, 뼈대가
banquet	연회, 축하연
expressive	의미심장한, 표현하는, 나타내는
instinctively	본능적으로, 직관적으로
lighting	조명, 점화, 점등
scanning	스캐닝, 주사, 정사
subordinate	부하의, 하위의, 종속시키다, 산하, 중요치 않은
patent	특허
courtyard	마당, 안뜰
gulf	만, 걸프, 격차
detailed	상세한, 세목에 걸친, 파견된
closet	벽장, 작은 방, 헛간
compel	강요하다, ~하지 않을 수 없다, 매력적인, ~하게 하다, 압도적인
inland	내륙의, 국내의, 오지의
excepting	~이외는, ~을 제외하고, ~하지 않으면
pretext	핑계, 구실, 명목
legislative	입법의, 의회의, 법에 의한
rash	경솔한, 발진, 성급한, 뾰루지, 두드러기
margin	차이, 수익, 마진, 가장자리, 보증금
champion	챔피언, 우승자, 옹호하다, 투사
settling	결정, 해결, 정착
billion	10억, 막대한 수
betwixt	사이에(between)
admiring	감탄하는, 감탄한, 칭찬하는
morgan	남자 이름, 모건종, 모건
nick	새김눈, 교도소, 새김눈을 내다
chemical	화학적인, 화학물질, 화합물
worthless	무의미한, 가치 없는
aristocratic	귀족의, 귀족주의의, 귀족적인
nan	여자 이름, N자를 나타내는 부호, 할머니
especial	특별한, 뛰어난, 각별한
attentive	주의 깊은, 세심한, 친절한
maintenance	유지, 정비, 관리, 보수
charlie	C자를 나타내는 부호, 바보, 여자 아이
explanatory	설명을 위한, 주석적인, 설명적인
differently	다르게, 다양하게, 특별하게
furiously	극단적으로, 미친 듯 날뛰며, 맹렬하게
pulse	맥박, 파동
scanty	부족한, 모자란, 빠듯한, 불충분한, 근소한
flee	도망치다, 탈출하다, 피하다, 떠나다, 추방되다
admiral	해군 대장, 제독
clause	조항, 문구, 규정
resume	재개하다, 이력서, 다시 시작하다, 되찾다
compound	화합물, 합성물, 혼합물, 복합의, 악화시키다
pilot	조종사, 비행사, 시범, 파일럿, 예비의
charmed	마법에 사로잡힌, 마음을 빼앗긴, 저주받은
imitate	흉내내다, 모방하다, 따라 하다, 도용하다
happening	우연히 일어난 일, 사건, 우발 사건
knot	매듭, 노트, 난제
mock	조롱하다, 모의의, 가짜의
majestic	장엄한, 위엄 있는, 당당한
prussian	프러시아의, 프러시아인, 레트족
suspense	불안, 걱정, 미정
clare	여자 이름, 남자 이름
relationship	관계, 연애관계, 사이, 관련, 연관성
skirt	치마, 스커트
agency	기관, 소속사, 에이전시, 대행, 소개소
arisen	arise의 과거 분사형
grin	웃다, 웃음, 미소, 견디다
unusually	보통과는 달리, 비정상적으로, 대단히
michigan	미시간, 주도 Lansing. (약어)Mich., MI
hoarse	쉰 목소리의, 쉰, 목이 쉰
intently	집중하여, 열심히, 골똘하게
dining	식사하기, 식사, 정찬
demonstration	시위, 시연, 데모, 표출
depression	우울, 침체, 공황, 불경기, 불황
lain	lie의 과거 분사형
joining	접합, 연결, 접합점
weekly	주간, 매주
technical	기술의, 전문의
vehicle	자동차, 차량, 발사체, 이동수단, 매개물
borrow	빌리다, 대여하다, 차용하다, 빚지다
flattering	아첨하는, 기쁘게 하는, 실물보다 돋보이게 하는
portugal	포르투갈
prodigious	거대한, 막대한, 놀라운
scope	범위, 영역, 여지, 살펴보다, 한계
vegetation	초목, 식물, 식물의 생장
switzerland	스위스
arkansas	아칸소 강, 미국 중남부의 주, (약어)Ark., AR, 아칸소 강
swelling	증가하는, 부기, 높아지는, 팽창하는, 복받치다
fortified	영양가를 높인, 방어를 견고히 한, 강화된
salute	경례하다, 경의를 표하다
topic	주제, 화제, 관심, 토픽, 의제
superb	훌륭한, 최고의
strengthen	강화하다, 강하다, 튼튼하다, 증강시키다
confidential	기밀의, 비밀의, 흉금을 터놓는, 감추는
crow	까마귀, 크로우, 자랑하다, 시골사람들
shawl	어깨걸이, 숄, ~에 숄을 걸치다
sunrise	일출, 해돋이
sturdy	튼튼한, 견고한, 단단한, 불굴의
lifetime	평생, 일생, 삶, 살아있는 동안에, 수명
dispersed	분산된, 해산된, 사방으로 흩어진
sergeant	경사, 하사관, 병장, 상사, 중사
contribute	기여하다, 공헌하다, 도움이 되다, 기부하다, 제공하다
strode	stride의 과거형
brigade	~을 여단으로 편성하다, 여단, 조직
verdict	판결, 심판, 결정, 의견
they've	they have의 단축형
panting	헐떡거리는, 두근거리는
attribute	원인으로 여기다, ~로 여기다, 때문이라고 생각한다, 탓으로 돌리다, ~에 따른
hook	훅하다, 빠지다, 갈고리, 바늘
discontent	불평을 품은, 불만, 불만스러운
orderly	질서있는, 정연한, 잡역부, 규칙을 따라
tiger	호랑이, 타이거
penetrate	침투하다, 파고들다, 관통하다, 발견하다, 넘어서다
sabbath	안식일, 휴식 시간, 안식
identification	신분증, 표시, 신원 확인, 증명, 공감
holiness	신성, 고결, 성하
crooked	구부러진, 굽은, 비뚤어진
housekeeper	가정부, 주부
prescribed	규정된, 예정된, 지령에 의한
rector	감독 교회의 교구 목사, 교장, 총장
spark	촉발시키다, 불꽃, 스파크, 야기하다, 유발하다
sleeve	소매, 슬리브
honored	명예로운, 영광으로 생각하여
tame	길들이다, 억제하다, 완화하다, 온순한
highway	고속도로, 간선도로, 하이웨이
alabama	앨라배마, 미국 남동부의 주, 앨라배마 강
edmund	에드먼드, 남자 이름
militia	시민군, 예비군, 민병
nobleman	귀족, 노블맨
spacious	넓은, 널찍한, 공간이 넓은
tearing	맹렬한, 황급한, 괴로운
affliction	고통, 고뇌, 불행
photograph	사진
ally	동맹, 우방, 연합, 협력, 동지
hampshire	햄프셔, 영국 잉글랜드 남부의 주
ascent	오르기, 등반, 승진
ditch	버리다, 도랑, 따돌리다, 결석하다
jupiter	주피터, 그리스 신화의 Zeus, 목성
rubbing	탁본, 마찰, 안마
tract	지역, 관
afore	before,「앞에, 이전의」의 뜻
ribbon	리본
cecilia	여자 이름
oregon	오리건, 미국 서북부 태평양 연안의 주(약어)Oreg., Ore., OR
integrity	도덕성, 진실성, 고결함, 위상, 온전함
plus	게다가, 플러스, 또한, 더욱이, 이상의
transparent	투명한, 속보이는, 솔직한
pulpit	설교단, 강론단, 성직자
nineteen	열아홉
counting	계산, 집계, 계표
perfume	향수, 향기
socrates	소크라테스, 고대 아테네의 철학
bother	성가시게 하다, 괴롭히다, 신경쓰이다, 귀찮게 하다, 걱정하다
fascinating	멋진, 매혹적인, 재미있는
qualified	자격이 있는, 적임의, 자질이 있는, 적합한
desolation	쓸쓸함, 황량한 곳, 슬픔
essay	에세이, 작문, 논문, 수필, 시도하다
renew	갱신하다, 재개하다, 연장하다, 회복하다, 새롭게 하다
odious	싫은, 미운, 증오할
assuredly	확실히, 틀림없이, 자신을 가지고
rider	기수, ~을 타는 사람, 승객
loneliness	고독, 쓸쓸함, 홀몸임
pond	연못, 호수, 우물
dazzling	눈부신, 빛나는, 휘황찬란한
squadron	비행중대, 소함대, 단체
bowing	운궁, 연주법, 절하기
novelty	신기함, 새로움
wrist	손목, 가벼운 처벌, 팔목
keeper	사육사, 지키는 사람, 주인
homeward	집으로 향하여, 집으로 돌아가는 길의, 귀로의
alexandria	알렉산드리아, 이집트 공화국 북부의 항구 도시
finely	훌륭하게, 아름답게, 미세하게
li	lithium(리튬), light infantry(경장 보병대)
efficiency	효율, 능률, 연비, 수익율, 효과적인
marvel	놀라다, 경이로움, 경탄하다
agnes	여자 이름, 성 아그네스, Saint
spenser	남자 이름, SPENCER, Edmund, 스펜서
condemn	비난하다, 규탄하다, 유죄 판결을 내리다, 미워하다
julian	남자 이름, 율리아누스, Julius Caesar의
sweetly	상냥하게, 귀엽게, 즐겁게
endurance	지구력, 인내, 내구성
bags	다량, 다수, 차지하다
jaw	턱, 입, 수다
unique	독특한, 특별한, 특이한, 고유의, 유일한
navigation	네비게이션, 항해, 항법, 해운
inevitably	불가피하게, 필연적으로, 결국
admirably	훌륭하게
sect	종파, 파벌, 교파
drum	드럼, 북
verge	가장자리, 경계, 변두리
piercing	날카로운, 통찰력 있는, 새된
sanction	제재, 인정하다, 허가, 지지, 처벌
forlorn	고독한, 버림받은, 쓸쓸한
approbation	승인, 시인, 칭찬
organic	유기적인, 근본적인, 장기의, 조직적
stanley	남자 이름, 스탠리
allegiance	충성, 충실
bin	뚜껑 달린 상자, ~을 휴지통에 버리다, bi-의 별형
expressly	명백히, 특별히, 확실히
ingenuity	발명의 재간, 창의력, 교묘한 고안
dispose	처리하다, 처분하다, 폐기하다
stained	명사와 결합하여 「~으로 더럽혀진」의 뜻, 얼룩진, 오염된
theology	신학, 신학 이론, 종교 심리학
withal	게다가, 동시에, ~으로
duration	지속기간, ~동안, 내내, ~하는 중
fundraising	자금 조달, 모금
collecting	모금용의, 수집, 모금
weigh	무게가 나가다, 압박하다, 판단하다, 무게를 재다, 비중을 갖다
float	떠오르다, 떠다니다
consul	영사, 집정, 집정관
monastery	수도원, 수도사의 단체, 수사 단체
raging	사납게 날뛰는, 격렬한, 극심한
publish	출판하다, 출간하다, 발표하다, 게재하다, 발행하다
knocking	노킹, 문을 두드리는 일, 노크
precaution	예방, 주의, 대비, 조심, 경계
privately	개인적으로, 사적으로
aaron	아론, 모세의 형, 유대교 최초의 제사장
insight	통찰력, 보여줌, 이해, 식견
definitely	분명히, 확실하게, 반드시, 물론, 완전히
stature	신장, 키, 위업, 성장
troy	소아시아 북서부의 고대 도시, 트로이형으로 표시한, troy weight
miriam	여자 이름
judah	유다, 유다족, 유다 왕국
oblige	~에게 강요하다
urging	재촉하는, 귀찮은, 성가신
shift	변화, 전환, 바뀌다, 옮기다, 근무
mould	곰팡이, 주형, 형성하다, 형태
countless	많은, 셀 수 없는, 다양한
hymn	찬송가, 찬가
rapture	황홀감, 무아지경
tonight	오늘밤, 오늘 저녁, 투나잇
trumpet	트럼펫, 자랑스럽게 알리다, 나팔, 나팔같은 울음소리를 내다, 자화자찬
parker	파커
firmness	견고, 견실, 확고부동
comic	만화의, 코믹스, 코미디, 희극
breeding	번식, 사육, 품종 개량
ken	알고 있다, 시야, 은신처
questioning	의문, 질문, 의문을 나타내는
factor	요인, 요소, 원인, 유전자, 인수
loveliness	사랑스러움, 멋짐
handled	핸들이 있는, 자루가 달린
saloon	술집, 객실, 응접실
witch	마녀
traveling	순회하는, 이동하는, 여행
backed	등가 달린, 뒷받침이 있는, 배경이 있는
profoundly	깊은 곳에서, 절실히, 충심으로
gladness	기쁨, 즐거움
pomp	화려, 장관, 허식, pompadour
mess	엉망, 망치다, 혼란, 어지럽히다, 난장판
practise	연습하다, 숭배하다
sanctuary	피난처, 성역, 지성소
superstitious	미신적인
casual	캐주얼의, 편한, 평상복의, 평상시의, 우연한
iowa	아이오와, 미국 중부의 주, (약어)Ia., Io., IA, 아이오와족
historic	역사적인, 사
bored	지루한, 싫증난
shrink	줄다, 감소하다, 위축되다, 축소되다, 정신과 의사
expenditure	지출, 비용, 소비
encouraging	격려하는, 용기를 북돋아 주는, 고무적인, 격려가 되는
diplomatic	외교적인, 외교관의
forcing	강제, 폭행, 탈취
studio	스튜디오, 원룸, 화실
exposure	노출, 폭로, 드러남, 적발, 유출
crude	천연 그대로의, 조잡한, 거친
compilation	편집, 편찬, 편집물
vermont	버몬트, 미국 북동부의 주, (약어)Vt., VT
eve	이브, 전날 밤
ascend	오르다, 상승하다, 승진하다
unbroken	깨지지 않은, 온전한, 연속된
apollo	아폴로, 빛·음악·시·예언·남성미의 신, 태양
countess	백작 부인, 여자 백작
binding	의무적인, 묶기, 구속력이 있는
exceed	넘어서다, 초과하다, 능가하다
frail	허약한, 빈약한
hans	남자 이름, 독일인, 네덜란드인의 별명, 독일 사람
champagne	샴페인, 샴페인의, 샴페인색
carter	카터
mule	노새, 고집쟁이, 뮬
inserted	끼워넣은, 뼈에 부착한, 부착점이 있는
parson	파슨스, 교구 목사
rascal	악한, 악당, 불량배의
inspire	영감을 주다, 고무하다, 격려하다, 고취하다
banner	현수막, 배너, 기치, 대표
divorce	이혼, 분리, 분열, 결별
treacherous	배반하는, 반역하는, 딴 마음을 먹은
nineteenth	19세기, 열아홉번째, 십구 분의 일
invalid	무효한, 타당하지 않은, 장애인, 유효기간이 지난
bolt	볼트, 번개, 탈퇴하다, 벗어나다, 나사못
ticket	승차권, 티켓, 표, 입장권, 딱지
backwards	뒤로, 거꾸로, 후진적인
captivity	속박, 감금, 포로
lame	절름발이의, 서투른, 불충분한
vein	맥락, 정맥, 광맥
lists	시합장, 투기장, 그 목책
gallop	치솟다, 질주하다
dagger	단검, 칼표, 적의
passive	수동적인, 소극적인, 간접, 신중한
shoe	신발, 구두
thrice	세 번, 3배로, 3회
mystic	신비주의의, 신비론자, 비전의
infancy	유아기, 초기
foam	거품, 폼, 스펀지, 크림, 발포시키다
keith	남자 이름
tavern	선술집, 여인숙, 여관
fraud	사기, 사기꾼, 기만
cradle	요람, 어린 시절, 낫
vigorously	강하게, 정력적으로, 필사적으로, 엄밀한
censure	비난, 비난하다, 불신임의 표명
gentleness	온화함, 관대함
monotonous	단조로운, 지루한
explosion	폭발, 급증
catastrophe	대참사, 재난
respectfully	공손하게, 정중하게, 예의바르게
blamed	빌어먹을, 되게, 지긋지긋한
needful	필요한, 불가결한, 돈
fireplace	벽난로
gravel	자갈, 어리둥절하게 하다
jar	병, 항아리, 단지
selfishness	이기주의, 이기심, 이기적인, 욕심
tolerably	참을 수 있을 정도로, 웬만하게, 꽤
ark	방주, 성궤, 피난처, 평저선
moist	촉촉한, 습한, 눈물이 많은
sauce	소스, 양념
writ	영장, 문서, 공식 서한
bruce	남자 이름, 브루스
insolent	오만한, 건방진, 무례한
moisture	수분, 습기
thompson	톰프슨, 톰슨
furnace	용광로, 화장로, 난방로
healing	치유, 치료, 힐링
fewer	보다 소수의, 보다 소수의 사람
deem	간주하다, 생각하다, 여기다
apron	앞치마, 에이프런, 가림막
humiliation	창피를 주기, 굴욕, 면목 없음
punctuation	구두점, 구두법
rolls	롤스로이스, 롤즈로이스, 최고급품
doe	암컷, Department of Energy(에너지부), depends on experience(경험자 우대)
rotten	썩은, 형편없는, 무례한, 망치다, 썩은 내 나는
swiss	스위스
behavior	행동, 행위, 태도, 행태, 행실
nowadays	요즈음, 오늘날, 현재, 최근
pamphlet	팸플릿, 소책자, 인쇄물
loan	대출, 빌려 주다, 빚, 채권, 융자
divers	몇 개의, 여러 가지의, 몇 사람
unreasonable	불합리한, 무리한
realise	깨닫다, 알다, 실현하다, 인식하다, 알아차리다
lust	욕망, 정욕, 갈망
ah	아
annually	매년, 연간, 한해에
detach	~을 분리하다, 단독의, 초연한, 거리를 두다, 소외되다
gaily	화려하게, 명랑하게, 유쾌하게
gifted	천부의 재능이 있는, 탁월한 재능을 지닌, 타고난
planet	행성, 혹성, 유성
feverish	열성의, 열이 있는
resurrection	부활, 되살아남, 그리스도의 부활
saul	사울, 이스라엘의 초대 왕, 남자 이름
enforced	강제적인
vincent	성 빈첸티우스, 포도 재배자의 수호 성인, 남자 이름
shelf	선반, 매장, 대륙붕
fan	팬, 좋아하는, 선풍기, 부채, 흩어지다
fluid	액체, 수분, 유동성의, 순조로운
brightly	밝게, 상냥하게, 활짝
damsel	처녀, 소녀, 계집아이
gabriel	남자 이름, 천사 가브리엘, Jacques-Anges, 가브리엘
kid	아이, 어린이, 놀리다, 농담하다, 아들
frantic	제정신이 아닌, 굉장한, 미친 듯한
neatly	깔끔하게, 솜씨 있게
anon	머지않아, 곧, anonymous
ascribed	부여받은
insane	미친, 정신 이상의, 비상식적인, 미친 듯한
tropical	열대의
milan	밀라노, 이탈리아 북부 Lombardy주의 주도
hardened	단단해진, 단련된, 강해진
overthrow	전복시키다, 타도하다, 끌어내리다, 폐지하다
phase	단계, 국면, ~차, 조정하다, 상태
achievement	업적, 성취, 성적, 개가
immortality	불후, 영원, 불사
obscurity	불명료, 애매한 상태, 알려지지않음
assumption	가정, 추측, 가설, 인수
discern	식별하다, 분간하다, 알아차리다
hopeful	가망있는, 희망적인, 기대하는, 유망한
humorous	우스운, 유머러스한
composure	침착, 냉정, 평정
turf	영역, 세력권, 잔디, 몰아내다
poland	폴란드
dame	귀부인, 신분이 있는 여성, 신분이 있는 여성의 존칭
orator	웅변가, 연설자, 변사
perpetually	끊임없이, 부단히, 영구히
arbitrary	임의의, 독단적인, 제멋대로의
ecstasy	황홀, 황홀경, 무아의 경지
retirement	은퇴, 퇴직, 퇴임
pronounce	발음하다, 두드러지다
authorized	권한이 부여된, 정식으로 인가된, 위임된
familiarity	친밀함, 잘 알고 있음
hastings	헤이스팅스, 영국 잉글랜드 East Sussex주 남동해안의 도시, 뉴질랜드 노스 섬 동부의 도시
grievous	비통한, 통탄할, 슬픈
mercury	수은, 수성, 온도계, 머큐리
elegance	우아함, 고상함
chivalry	기사도, 기사 제도, 기사단
luminous	빛을 내는, 밝은, 야광의
beseech	호소하다, 간청하다, 청하다
benevolent	자비심이 많은, 친절한, 자비로운
perplexity	곤혹, 혼란, 당혹
terrific	대단한, 무서운
companionship	교제, 사귐, 우호
commence	시작하다
daisy	데이지
parliament	국회, 의회, 하원, 모임
creep	비열한 사람, 서서히 다가오다, 섬뜩하게 하다, 소폭으로 ~하다, 기어가다
pleading	변론, 탄원하는, 변명
disdain	경멸하다, 경멸, 멸시하다
pm	오후, 저녁
emergency	비상, 긴급한, 응급, 위기, 급변
parcel	소포, 한 구획, 일부분, 나누다, 꾸러미로 만들다
suicide	자살하다, 자멸하다
drawer	서랍
contribution	기여, 공헌, 기부, 기고
supposition	가정, 상상, 추정
weren't	were not의 단축형
link	연결, 연관, 연계, 링크, 고리
homely	가정적인, 편안한, 못생긴
pluck	뽑다, 용기, 빼앗다
ruling	판결, 결정, 집권하는, 지배, 심판
patrick	패트릭, 성 패트릭, 아일랜드의 수호 성인
hannah	여자 이름, 한나
printing	인쇄, 프린트, 출력
joshua	여호수아, 여호수아기, (약어)Josh
synonymous	동의어인, 유의어인, 뜻이 같은
sinister	불길한, 악의 있는, 사악한
advocate	옹호하다, 주장하다, 대변자, 변호사
destructive	파괴적인, 해로운
environment	환경, 상황, 자연, 분위기
blossom	꽃
bridle	굴레, 굴레를 씌우다, 속박
yon	저곳에, 저기 있는 것, 저쪽의 물건
waistcoat	남성용 조끼, 양복 조끼
confirm	확인하다, 공식화 하다, 확정하다, 입증하다, 승인하다
listing	표 작성, 일람표에의 기재, 변폭
solemnity	엄숙함, 장엄한 의식, 엄숙
reporter	기자, 리포터
deprive	빼앗다, 박탈하다, 부족하게 만들다, 허용치 않다, 가난한
detachment	분리, 초연, 무관심
infernal	지옥의, 지독한, 극악 무도한
moss	이끼, 모스
skilled	숙련된, 노련한, 유능한, 능숙한, 기술이 좋은
announce	발표하다, 밝히다, 알리다, 공표하다
hateful	미워하는, 지긋지긋한, 악의적인
fugitive	도망자, 변하기 쉬운, 일시적인
gothic	고딕 양식의, 고딕기의 미술 공예, 고딕파의
coolness	서늘함, 냉정, 냉담
insurrection	반란, 폭동, 반역
med	medical, medicine, medieval
coachman	마부, 마차꾼, 제물 낚시
expend	들이다, 소비하다, 쓰다
julius	남자 이름, 율리우스
resign	사임하다, 사퇴하다, 물러나다, 사의를 표하다
despatch	신속함, 특전, 파견
reject	거부하다, 거절하다, 기각하다, 부인하다, 받아들이지 않다
tough	힘든, 어려운, 강한, 터프한, 거친
plea	탄원, 호소, 답변, 진술
roy	남자 이름
fragment	파편, 분열하다, 무리
wordsworth	워즈워스
balcony	발코니
mac	남자 이름, 맥, 이봐
nevada	네바다, (약어)Nev., NV
christopher	남자 이름, 크리스토퍼
fork	포크, 갈래지다
flatter	아첨하다, 납작해지다, 자만하다, 돋보이게 하다
iniquity	사악, 심한 부정, 무도
meditation	명상
disastrous	피해가 막심한, 비참한
stain	얼룩, 자국, 오점, 더럽히다, 오염
whipped	매맞은, 거품을 일게 한, 휘저어 거품을 일게 한
burial	매장, 묘소, 장례, 매몰지
matt	남자 이름, 무광의, 마태복음
employee	직원, 직장인, 고용인, 근로자, 종업원
employer	고용주, 회사, 사업주, 사용자, 경영자
hypothesis	가설, 가정, 추측
steed	말, 준마, 승마용 말
width	폭, 넓이
sweden	스웨덴
transaction	거래, 처리, 취급
devout	독실한, 헌신적인, 경건한 마음을 나타내는
outrage	~을 화나게 하다, 폭력 행위, 무도한 행위
vary	다양하다, 다르다, 달라지다
attorney	변호사,  지방 검사, 법무장관, 법정대리인,  위임장
rouse	깨우쳐서 하도록 하다, 일으키다, 깨우다, 눈을 뜨다
sidney	남자 이름, 여자 이름, Sir Philip, 시드니
schooner	스쿠너, 큰 유리컵, 큰 컵
flaming	타는 듯이 붉은, 타오르는, 이글거리는
offend	기분이 상하다, 불쾌하게 하다, 성나게 하다, 위반하다, 해치다
sheriff	보안관
magnificence	장엄, 웅장, 웅대
vent	분출하다, 내다, 배출구, 분화구
politely	정중하게, 공손하게, 예의 바르게
vines	옷
austin	오스틴, 남자 이름
